chrom	start	end	length	chrom_	start_	end_	gene_name_	strand_	gene_len_	distance
chr1	7066405	7069093	2688	chr1	7079001	7163707	Pcmtd1	+	84706	9908
chr1	9628528	9630162	1634	chr1	9550913	9621256	2610203C22Rik	-	70343	7272
chr1	12992303	12993303	1000	chr1	12856630	12981258	Slco5a1	-	124628	11045
chr1	13041947	13043066	1119	chr1	13103538	13117244	Prdm14	-	13706	60472
chr1	13372758	13374812	2054	chr1	13129186	13364164	Ncoa2	-	234978	8594
chr1	13375170	13376230	1060	chr1	13129186	13364164	Ncoa2	-	234978	11006
chr1	13415479	13417770	2291	chr1	13129186	13364164	Ncoa2	-	234978	51315
chr1	13503662	13505101	1439	chr1	13554783	13579945	Tram1	-	25162	49682
chr1	13588833	13589894	1061	chr1	13554783	13579945	Tram1	-	25162	8888
chr1	13741792	13744557	2765	chr1	13764415	13764545	SNORA17	-	130	19858
chr1	13776447	13780172	3725	chr1	13764415	13764545	SNORA17	-	130	11902
chr1	14094563	14095563	1000	chr1	14159035	14300281	Eya1	-	141246	63472
chr1	14133767	14134869	1102	chr1	14159035	14300281	Eya1	-	141246	24166
chr1	14152210	14153210	1000	chr1	14159035	14300281	Eya1	-	141246	5825
chr1	14976476	14978654	2178	chr1	15009121	15009240	SNORA17	-	119	30467
chr1	14984752	14986338	1586	chr1	15009121	15009240	SNORA17	-	119	22783
chr1	14987501	14989345	1844	chr1	15009121	15009240	SNORA17	-	119	19776
chr1	15231640	15233766	2126	chr1	15258880	15259878	Gm10566	-	998	25114
chr1	16523160	16524494	1334	chr1	16218755	16510193	Stau2	-	291438	12967
chr1	16529270	16531479	2209	chr1	16218755	16510193	Stau2	-	291438	19077
chr1	16541793	16543899	2106	chr1	16559863	16609570	Ube2w	-	49707	15964
chr1	16748070	16749853	1783	chr1	16757095	16760241	Gm5828	-	3146	7242
chr1	21298561	21299561	1000	chr1	21275327	21288393	Gm4956	-	13066	10168
chr1	21322900	21324947	2047	chr1	21339722	21342281	Khdc1a	+	2559	14775
chr1	23406071	23407071	1000	chr1	23373263	23390014	Ogfrl1	-	16751	16057
chr1	23727092	23728254	1162	chr1	23768592	23855997	B3gat2	+	87405	40338
chr1	30848174	30851017	2843	chr1	30859187	30930539	Phf3	-	71352	8170
chr1	30954823	30956618	1795	chr1	30859187	30930539	Phf3	-	71352	24284
chr1	34541751	34543096	1345	chr1	34516591	34532499	Ptpn18	+	15908	9252
chr1	34567044	34568124	1080	chr1	34555275	34559907	Prss39	+	4632	7137
chr1	35866962	35868941	1979	chr1	35818447	35818551	U6	+	104	48411
chr1	35869169	35870224	1055	chr1	35818447	35818551	U6	+	104	50618
chr1	35881932	35884550	2618	chr1	35818447	35818551	U6	+	104	63381
chr1	35916999	35920216	3217	chr1	35818447	35818551	U6	+	104	98448
chr1	35991829	35992829	1000	chr1	36125245	36163291	Hs6st1	+	38046	132416
chr1	36037460	36039236	1776	chr1	36125245	36163291	Hs6st1	+	38046	86009
chr1	36108351	36111351	3000	chr1	36125245	36163291	Hs6st1	+	38046	13894
chr1	36184898	36187009	2111	chr1	36198375	36301150	Uggt1	-	102775	11366
chr1	36311343	36312343	1000	chr1	36321447	36330270	Neurl3	-	8823	9104
chr1	36338099	36340074	1975	chr1	36321447	36330270	Neurl3	-	8823	7829
chr1	36349251	36353992	4741	chr1	36364578	36380874	Arid5a	+	16296	10586
chr1	36355234	36356234	1000	chr1	36364578	36380874	Arid5a	+	16296	8344
chr1	37043334	37046152	2818	chr1	37062284	37062402	n-R5s210	+	118	16132
chr1	37052037	37054161	2124	chr1	37062284	37062402	n-R5s210	+	118	8123
chr1	37622950	37624013	1063	chr1	37496185	37597861	Mgat4a	-	101676	25089
chr1	37641673	37643468	1795	chr1	37668522	37776930	2010300C02Rik	-	108408	25054
chr1	38826590	38828738	2148	chr1	38850514	38892935	Lonrf2	-	42421	21776
chr1	38833386	38835568	2182	chr1	38850514	38892935	Lonrf2	-	42421	14946
chr1	39081920	39083329	1409	chr1	39044659	39054081	Pdcl3	+	9422	27839
chr1	39559382	39560389	1007	chr1	39576378	39576591	U3	+	213	15989
chr1	39791021	39792124	1103	chr1	39722151	39777842	Rfx8	-	55691	13179
chr1	39898295	39899419	1124	chr1	39861028	39861189	Gm3646	-	161	37106
chr1	39902691	39904354	1663	chr1	39861028	39861189	Gm3646	-	161	41502
chr1	40101601	40104155	2554	chr1	39957758	40083155	Map4k4	+	125397	18446
chr1	40106655	40112053	5398	chr1	40133073	40142698	Gm16894	-	9625	21020
chr1	40114913	40116929	2016	chr1	40133073	40142698	Gm16894	-	9625	16144
chr1	43280225	43281995	1770	chr1	43246001	43246483	Gm8210	+	482	33742
chr1	43413775	43419365	5590	chr1	43502596	43627360	Nck2	+	124764	83231
chr1	43431171	43432826	1655	chr1	43502596	43627360	Nck2	+	124764	69770
chr1	44098463	44100021	1558	chr1	44112797	44118781	Gm8251	-	5984	12776
chr1	46920448	46921448	1000	chr1	46864389	46910891	Slc39a10	-	46502	9557
chr1	46950942	46952139	1197	chr1	46864389	46910891	Slc39a10	-	46502	40051
chr1	46973579	46977350	3771	chr1	46864389	46910891	Slc39a10	-	46502	62688
chr1	46978290	46979514	1224	chr1	46864389	46910891	Slc39a10	-	46502	67399
chr1	51501621	51502621	1000	chr1	51526342	51535243	Obfc2a	-	8901	23721
chr1	51504387	51505997	1610	chr1	51526342	51535243	Obfc2a	-	8901	20345
chr1	51549971	51551061	1090	chr1	51526342	51535243	Obfc2a	-	8901	14728
chr1	51555212	51556212	1000	chr1	51526342	51535243	Obfc2a	-	8901	19969
chr1	51557357	51558808	1451	chr1	51526342	51535243	Obfc2a	-	8901	22114
chr1	51558853	51561370	2517	chr1	51526342	51535243	Obfc2a	-	8901	23610
chr1	51565809	51567033	1224	chr1	51526342	51535243	Obfc2a	-	8901	30566
chr1	51568736	51572447	3711	chr1	51526342	51535243	Obfc2a	-	8901	33493
chr1	51636441	51637441	1000	chr1	51526342	51535243	Obfc2a	-	8901	101198
chr1	51641076	51642815	1739	chr1	51526342	51535243	Obfc2a	-	8901	105833
chr1	51650020	51651675	1655	chr1	51526342	51535243	Obfc2a	-	8901	114777
chr1	51986793	51987816	1023	chr1	51997494	51998105	Gm8420	-	611	9678
chr1	52350741	52352222	1481	chr1	52220292	52290076	Gls	-	69784	60665
chr1	52420859	52424269	3410	chr1	52501280	52501388	U6	-	108	77011
chr1	52443806	52447573	3767	chr1	52501280	52501388	U6	-	108	53707
chr1	52465027	52468976	3949	chr1	52501280	52501388	U6	-	108	32304
chr1	52475241	52477306	2065	chr1	52501280	52501388	U6	-	108	23974
chr1	52486731	52489628	2897	chr1	52501280	52501388	U6	-	108	11652
chr1	52568321	52569913	1592	chr1	52514138	52557523	Nab1	-	43385	10798
chr1	52634417	52637388	2971	chr1	52687549	52708763	Tmem194b	+	21214	50161
chr1	52654613	52655613	1000	chr1	52687549	52708763	Tmem194b	+	21214	31936
chr1	52820446	52821823	1377	chr1	52846257	52874532	Inpp1	-	28275	24434
chr1	53042826	53043826	1000	chr1	52979168	53020104	1700019D03Rik	-	40936	22722
chr1	53763067	53764067	1000	chr1	53812350	53842068	Stk17b	-	29718	48283
chr1	53853778	53855474	1696	chr1	53863726	54252012	Hecw2	-	388286	8252
chr1	54991494	54992682	1188	chr1	54702184	54983231	Ankrd44	-	281047	8263
chr1	55174850	55176167	1317	chr1	55184141	55185131	Gm16581	+	990	7974
chr1	55436683	55438615	1932	chr1	55305502	55420313	Boll	-	114811	16370
chr1	56014511	56015511	1000	chr1	55463232	55808646	Plcl1	+	345414	205865
chr1	56770190	56771190	1000	chr1	56692897	56694295	Hsfy2	-	1398	75895
chr1	58689831	58690848	1017	chr1	58703452	58705161	Gm10068	+	1709	12604
chr1	58826968	58827968	1000	chr1	58768352	58815728	Cflar	+	47376	11240
chr1	58830086	58831086	1000	chr1	58768352	58815728	Cflar	+	47376	14358
chr1	58913089	58915716	2627	chr1	58852218	58904347	Casp8	+	52129	8742
chr1	58939309	58940540	1231	chr1	58957293	59030274	Trak2	-	72981	16753
chr1	58946139	58951057	4918	chr1	58957293	59030274	Trak2	-	72981	6236
chr1	60214688	60215688	1000	chr1	60155091	60207876	Carf	+	52785	6812
chr1	60992902	60994844	1942	chr1	61005074	61005309	Gm11582	-	235	10230
chr1	61195962	61198314	2352	chr1	61178222	61180848	Gm11590	-	2626	15114
chr1	61622799	61623799	1000	chr1	61663517	61667723	4930587A21Rik	-	4206	39718
chr1	64046329	64049308	2979	chr1	64076021	64168856	Klf7	-	92835	26713
chr1	64238101	64240520	2419	chr1	64196775	64197239	Gm13750	+	464	40862
chr1	64348820	64350458	1638	chr1	64442908	64442977	AC167197.1	+	69	92450
chr1	64351372	64352563	1191	chr1	64442908	64442977	AC167197.1	+	69	90345
chr1	71173649	71174719	1070	chr1	71074072	71149720	Bard1	-	75648	23929
chr1	71805952	71808216	2264	chr1	71756276	71756629	Gm5829	-	353	49323
chr1	74273416	74274847	1431	chr1	74283071	74314783	Arpc2	+	31712	8224
chr1	75157959	75158959	1000	chr1	75165220	75168203	Zfand2b	+	2983	6261
chr1	79577295	79578900	1605	chr1	79603451	79668547	Ap1s3	-	65096	24551
chr1	80365125	80366526	1401	chr1	80379679	80381763	Gm6189	-	2084	13153
chr1	80398447	80399566	1119	chr1	80379679	80381763	Gm6189	-	2084	16684
chr1	80400336	80401336	1000	chr1	80379679	80381763	Gm6189	-	2084	18573
chr1	80401854	80403013	1159	chr1	80379679	80381763	Gm6189	-	2084	20091
chr1	80412341	80413719	1378	chr1	80379679	80381763	Gm6189	-	2084	30578
chr1	80414290	80415290	1000	chr1	80379679	80381763	Gm6189	-	2084	32527
chr1	80423352	80425112	1760	chr1	80379679	80381763	Gm6189	-	2084	41589
chr1	80760816	80763504	2688	chr1	80497648	80755128	Dock10	-	257480	5688
chr1	81838473	81839588	1115	chr1	81738560	81739544	Gm5530	-	984	98929
chr1	87394631	87395631	1000	chr1	87407708	87423736	Gm16092	-	16028	12077
chr1	87869186	87872105	2919	chr1	87836112	87857630	Gpr55	-	21518	11556
chr1	87872439	87875313	2874	chr1	87836112	87857630	Gpr55	-	21518	14809
chr1	87882222	87883222	1000	chr1	87836112	87857630	Gpr55	-	21518	24592
chr1	87894054	87895353	1299	chr1	87913391	87926533	Spata3	+	13142	18038
chr1	87901971	87902971	1000	chr1	87913391	87926533	Spata3	+	13142	10420
chr1	87903670	87904783	1113	chr1	87913391	87926533	Spata3	+	13142	8608
chr1	88290367	88291855	1488	chr1	88282817	88284737	Nmur1	-	1920	5630
chr1	88330207	88332015	1808	chr1	88322946	88324538	1700019O17Rik	+	1592	5669
chr1	88342447	88345373	2926	chr1	88322946	88324538	1700019O17Rik	+	1592	17909
chr1	88349743	88350743	1000	chr1	88370234	88370581	Rpl30-ps6	+	347	19491
chr1	88383254	88385418	2164	chr1	88370234	88370581	Rpl30-ps6	+	347	12673
chr1	88388167	88389677	1510	chr1	88370234	88370581	Rpl30-ps6	+	347	17586
chr1	88393959	88399483	5524	chr1	88370234	88370581	Rpl30-ps6	+	347	23378
chr1	88405878	88411111	5233	chr1	88423311	88427273	Ptma	+	3962	12200
chr1	88412491	88413535	1044	chr1	88423311	88427273	Ptma	+	3962	9776
chr1	90472203	90473522	1319	chr1	90397698	90406461	Glrp1	-	8763	65742
chr1	90479276	90481641	2365	chr1	90397698	90406461	Glrp1	-	8763	72815
chr1	90483104	90485067	1963	chr1	90397698	90406461	Glrp1	-	8763	76643
chr1	90548687	90549693	1006	chr1	90569700	90598796	Arl4c	-	29096	20007
chr1	92076115	92079381	3266	chr1	92100555	92113326	Cxcr7	+	12771	21174
chr1	92265148	92266193	1045	chr1	92100555	92113326	Cxcr7	+	12771	151822
chr1	93302008	93303008	1000	chr1	93308060	93310615	Hes6	-	2555	5052
chr1	94076015	94077842	1827	chr1	93829334	94044970	Hdac4	-	215636	31045
chr1	94614164	94615926	1762	chr1	94540795	94545418	Otos	-	4623	68746
chr1	95565023	95566082	1059	chr1	95549077	95549367	AC131316.1	+	290	15656
chr1	95974890	95975890	1000	chr1	95934884	95949130	Pdcd1	-	14246	25760
chr1	96724043	96725043	1000	chr1	96936511	96936620	SNORA17	-	109	211468
chr1	97163933	97167048	3115	chr1	97210205	97231861	Fam174a	+	21656	43157
chr1	97276688	97277688	1000	chr1	97210205	97231861	Fam174a	+	21656	44827
chr1	97347256	97348256	1000	chr1	97395142	97395805	Gm15427	+	663	46886
chr1	97363970	97365495	1525	chr1	97395142	97395805	Gm15427	+	663	29647
chr1	97468775	97470280	1505	chr1	97462119	97462181	U7	-	62	6594
chr1	97650738	97651738	1000	chr1	97728706	97728812	U6	-	106	76968
chr1	99394082	99395082	1000	chr1	99540480	99558651	D1Ertd622e	-	18171	145398
chr1	99476616	99478143	1527	chr1	99540480	99558651	D1Ertd622e	-	18171	62337
chr1	99480057	99482631	2574	chr1	99540480	99558651	D1Ertd622e	-	18171	57849
chr1	107863978	107865034	1056	chr1	107842131	107842237	U6	+	106	21741
chr1	107867811	107869009	1198	chr1	107886983	107930651	Zcchc2	+	43668	17974
chr1	107869913	107870913	1000	chr1	107886983	107930651	Zcchc2	+	43668	16070
chr1	107877267	107878512	1245	chr1	107886983	107930651	Zcchc2	+	43668	8471
chr1	107954572	107958811	4239	chr1	107886983	107930651	Zcchc2	+	43668	23921
chr1	107966945	107968865	1920	chr1	107886983	107930651	Zcchc2	+	43668	36294
chr1	108041049	108042519	1470	chr1	108068329	108290827	Phlpp1	+	222498	25810
chr1	108044909	108046787	1878	chr1	108068329	108290827	Phlpp1	+	222498	21542
chr1	108053926	108056032	2106	chr1	108068329	108290827	Phlpp1	+	222498	12297
chr1	108058426	108059576	1150	chr1	108068329	108290827	Phlpp1	+	222498	8753
chr1	108418837	108419837	1000	chr1	108434755	108610851	Bcl2	-	176096	14918
chr1	121995304	121997281	1977	chr1	122009857	122017655	Dbi	-	7798	12576
chr1	122428005	122429005	1000	chr1	122371115	122401661	Marco	-	30546	26344
chr1	127337183	127338317	1134	chr1	127289483	127332067	Actr3	-	42584	5116
chr1	130340386	130341624	1238	chr1	130260285	130313993	Dars	-	53708	26393
chr1	130425472	130427329	1857	chr1	130411692	130411796	U6	-	104	13676
chr1	130497217	130498849	1632	chr1	130484776	130488870	Cxcr4	-	4094	8347
chr1	130508079	130511989	3910	chr1	130484776	130488870	Cxcr4	-	4094	19209
chr1	130514012	130515559	1547	chr1	130484776	130488870	Cxcr4	-	4094	25142
chr1	130518992	130520532	1540	chr1	130484776	130488870	Cxcr4	-	4094	30122
chr1	130558439	130560949	2510	chr1	130484776	130488870	Cxcr4	-	4094	69569
chr1	130592090	130593090	1000	chr1	130667176	130670998	Gm17699	-	3822	74086
chr1	130600900	130602275	1375	chr1	130667176	130670998	Gm17699	-	3822	64901
chr1	130683395	130684395	1000	chr1	130667176	130670998	Gm17699	-	3822	12397
chr1	130728130	130729766	1636	chr1	130782486	130782596	U6	-	110	52720
chr1	132671733	132673535	1802	chr1	132697479	132711317	Fcamr	+	13838	23944
chr1	132889387	132891822	2435	chr1	132916422	132921551	Il10	+	5129	24600
chr1	132895367	132897403	2036	chr1	132916422	132921551	Il10	+	5129	19019
chr1	132899091	132901271	2180	chr1	132916422	132921551	Il10	+	5129	15151
chr1	132906290	132908522	2232	chr1	132916422	132921551	Il10	+	5129	7900
chr1	132933771	132935637	1866	chr1	132916422	132921551	Il10	+	5129	12220
chr1	132942397	132944339	1942	chr1	132950281	132994144	Mapkapk2	-	43863	5942
chr1	133005101	133006843	1742	chr1	132998970	132999322	7SK	-	352	5779
chr1	133010059	133011135	1076	chr1	132998970	132999322	7SK	-	352	10737
chr1	133042104	133043350	1246	chr1	133049758	133084235	Eif2d	+	34477	6408
chr1	133462165	133463188	1023	chr1	133424480	133436449	Fam72a	+	11969	25716
chr1	133888870	133891563	2693	chr1	133867186	133879540	Slc45a3	+	12354	9330
chr1	134237703	134239431	1728	chr1	134212703	134230065	Nuak2	+	17362	7638
chr1	134239793	134240886	1093	chr1	134212703	134230065	Nuak2	+	17362	9728
chr1	134929698	134931232	1534	chr1	134886422	134921943	Mdm4	-	35521	7755
chr1	135055286	135056286	1000	chr1	135027720	135036377	Ppp1r15b	+	8657	18909
chr1	135717558	135718558	1000	chr1	135599255	135697618	Atp2b4	-	98363	19940
chr1	135955062	135958255	3193	chr1	135933831	135944854	Fmod	+	11023	10208
chr1	135962983	135965286	2303	chr1	135971747	135975697	Btg2	-	3950	6461
chr1	135989450	135990782	1332	chr1	135971747	135975697	Btg2	-	3950	13753
chr1	135995636	135996669	1033	chr1	136005915	136006417	Gm8618	+	502	9246
chr1	136548147	136549267	1120	chr1	136538831	136543097	Gm3834	-	4266	5050
chr1	137825878	137827471	1593	chr1	137767972	137815784	Pkp1	-	47812	10094
chr1	138477614	138479579	1965	chr1	138518675	138521227	Gm17718	-	2552	39096
chr1	138496406	138497627	1221	chr1	138518675	138521227	Gm17718	-	2552	21048
chr1	138574391	138575433	1042	chr1	138592788	138622305	Gm16880	+	29517	17355
chr1	138580797	138581827	1030	chr1	138592788	138622305	Gm16880	+	29517	10961
chr1	139760915	139761915	1000	chr1	139824747	139826850	A130050O07Rik	+	2103	62832
chr1	139794373	139795985	1612	chr1	139824747	139826850	A130050O07Rik	+	2103	28762
chr1	139796644	139798051	1407	chr1	139824747	139826850	A130050O07Rik	+	2103	26696
chr1	139802049	139803151	1102	chr1	139824747	139826850	A130050O07Rik	+	2103	21596
chr1	139813300	139815010	1710	chr1	139824747	139826850	A130050O07Rik	+	2103	9737
chr1	140081877	140082877	1000	chr1	139959438	140071882	Ptprc	-	112444	9995
chr1	140086274	140089631	3357	chr1	139959438	140071882	Ptprc	-	112444	14392
chr1	140116493	140117867	1374	chr1	139959438	140071882	Ptprc	-	112444	44611
chr1	140142713	140146237	3524	chr1	140170315	140186037	Atp6v1g3	+	15722	24078
chr1	140157454	140159169	1715	chr1	140170315	140186037	Atp6v1g3	+	15722	11146
chr1	140163784	140164903	1119	chr1	140170315	140186037	Atp6v1g3	+	15722	5412
chr1	140195551	140197109	1558	chr1	140170315	140186037	Atp6v1g3	+	15722	9514
chr1	140218548	140221005	2457	chr1	140170315	140186037	Atp6v1g3	+	15722	32511
chr1	140817355	140820323	2968	chr1	140860013	141072620	Dennd1b	+	212607	39690
chr1	140826812	140828512	1700	chr1	140860013	141072620	Dennd1b	+	212607	31501
chr1	140835606	140837566	1960	chr1	140860013	141072620	Dennd1b	+	212607	22447
chr1	140850979	140852421	1442	chr1	140860013	141072620	Dennd1b	+	212607	7592
chr1	141309259	141310457	1198	chr1	141318960	141349582	Zbtb41	+	30622	8503
chr1	144790115	144791826	1711	chr1	145445927	145550023	Cdc73	-	104096	654101
chr1	144791880	144792880	1000	chr1	145445927	145550023	Cdc73	-	104096	653047
chr1	145762743	145765531	2788	chr1	145846468	145851291	Rgs2	-	4823	80937
chr1	146044940	146045940	1000	chr1	145985797	146024502	Rgs13	-	38705	20438
chr1	146046115	146048001	1886	chr1	145985797	146024502	Rgs13	-	38705	21613
chr1	146049307	146050307	1000	chr1	145985797	146024502	Rgs13	-	38705	24805
chr1	146051051	146052051	1000	chr1	145985797	146024502	Rgs13	-	38705	26549
chr1	146061742	146063573	1831	chr1	146091102	146096372	Rgs1	-	5270	27529
chr1	146147734	146148790	1056	chr1	146091102	146096372	Rgs1	-	5270	51362
chr1	146153092	146157542	4450	chr1	146091102	146096372	Rgs1	-	5270	56720
chr1	146158921	146161444	2523	chr1	146091102	146096372	Rgs1	-	5270	62549
chr1	146176699	146178508	1809	chr1	146091102	146096372	Rgs1	-	5270	80327
chr1	146202732	146203732	1000	chr1	146091102	146096372	Rgs1	-	5270	106360
chr1	148105958	148107513	1555	chr1	148267564	148268004	Gm5263	+	440	160051
chr1	148813939	148816535	2596	chr1	148342759	148749602	Fam5c	+	406843	64337
chr1	149059625	149063074	3449	chr1	149127888	149129072	Gm9931	-	1184	64814
chr1	152871822	152873187	1365	chr1	152410657	152840565	Hmcn1	-	429908	31257
chr1	153023557	153025778	2221	chr1	153107954	153108044	U2	-	90	82176
chr1	153097326	153098926	1600	chr1	153107954	153108044	U2	-	90	9028
chr1	153132224	153133224	1000	chr1	153107954	153108044	U2	-	90	24180
chr1	153134084	153135154	1070	chr1	153160677	153160758	Y_RNA	+	81	25523
chr1	154644587	154646238	1651	chr1	154655020	154684120	Ncf2	+	29100	8782
chr1	155429522	155431455	1933	chr1	155350146	155396844	Npl	-	46698	32678
chr1	155463923	155464957	1034	chr1	155500155	155544797	Rgs8	+	44642	35198
chr1	155569827	155570827	1000	chr1	155587479	155592598	Rgs16	+	5119	16652
chr1	155950180	155951362	1182	chr1	155927225	155927329	SNORA17	-	104	22851
chr1	156641538	156642538	1000	chr1	156239649	156573049	Cacna1e	-	333400	68489
chr1	156669525	156670525	1000	chr1	156239649	156573049	Cacna1e	-	333400	96476
chr1	156685141	156689468	4327	chr1	156239649	156573049	Cacna1e	-	333400	112092
chr1	156693973	156696381	2408	chr1	156239649	156573049	Cacna1e	-	333400	120924
chr1	156697406	156698528	1122	chr1	156239649	156573049	Cacna1e	-	333400	124357
chr1	156701147	156702195	1048	chr1	156239649	156573049	Cacna1e	-	333400	128098
chr1	156885980	156888598	2618	chr1	156910653	156930396	Gm9530	-	19743	22055
chr1	156901905	156903791	1886	chr1	156910653	156930396	Gm9530	-	19743	6862
chr1	156967283	156969576	2293	chr1	156975008	156993910	Mr1	-	18902	5432
chr1	157091073	157092073	1000	chr1	157059603	157079870	BC034090	-	20267	11203
chr1	158350356	158351694	1338	chr1	158358239	158404459	Soat1	-	46220	6545
chr1	158885673	158887567	1894	chr1	158734297	158869757	Ralgps2	-	135460	15916
chr1	158915820	158917395	1575	chr1	158734297	158869757	Ralgps2	-	135460	46063
chr1	158919062	158925731	6669	chr1	158734297	158869757	Ralgps2	-	135460	49305
chr1	158932861	158933861	1000	chr1	158734297	158869757	Ralgps2	-	135460	63104
chr1	158946557	158948120	1563	chr1	158734297	158869757	Ralgps2	-	135460	76800
chr1	158949443	158950603	1160	chr1	159029279	159038811	1700057K13Rik	-	9532	78676
chr1	158952652	158954909	2257	chr1	159029279	159038811	1700057K13Rik	-	9532	74370
chr1	158956375	158959486	3111	chr1	159029279	159038811	1700057K13Rik	-	9532	69793
chr1	158968662	158970735	2073	chr1	159029279	159038811	1700057K13Rik	-	9532	58544
chr1	158976746	158979610	2864	chr1	159029279	159038811	1700057K13Rik	-	9532	49669
chr1	158993205	158994295	1090	chr1	159029279	159038811	1700057K13Rik	-	9532	34984
chr1	159011193	159014043	2850	chr1	159029279	159038811	1700057K13Rik	-	9532	15236
chr1	161921317	161923479	2162	chr1	161913627	161913736	SNORA17	-	109	7581
chr1	161928877	161929877	1000	chr1	161913627	161913736	SNORA17	-	109	15141
chr1	161937789	161939132	1343	chr1	161913627	161913736	SNORA17	-	109	24053
chr1	161953435	161955802	2367	chr1	161974515	162008559	4930523C07Rik	+	34044	18713
chr1	162761067	162762067	1000	chr1	162149305	162723069	Rabgap1l	-	573764	37998
chr1	162789773	162790955	1182	chr1	162806333	162806453	SNORA26	-	120	15378
chr1	162791104	162794195	3091	chr1	162806333	162806453	SNORA26	-	120	12138
chr1	163113185	163114185	1000	chr1	163072822	163099237	Ankrd45	+	26415	13948
chr1	163273464	163276014	2550	chr1	163325581	163348337	Tnfsf4	+	22756	49567
chr1	163280520	163281520	1000	chr1	163325581	163348337	Tnfsf4	+	22756	44061
chr1	163304891	163309453	4562	chr1	163325581	163348337	Tnfsf4	+	22756	16128
chr1	163365228	163367869	2641	chr1	163325581	163348337	Tnfsf4	+	22756	16891
chr1	163395812	163397610	1798	chr1	163424786	163435421	Tnfsf18	+	10635	27176
chr1	163411652	163412652	1000	chr1	163424786	163435421	Tnfsf18	+	10635	12134
chr1	163441608	163443796	2188	chr1	163424786	163435421	Tnfsf18	+	10635	6187
chr1	163446926	163448445	1519	chr1	163424786	163435421	Tnfsf18	+	10635	11505
chr1	163449328	163450648	1320	chr1	163424786	163435421	Tnfsf18	+	10635	13907
chr1	163453525	163455011	1486	chr1	163424786	163435421	Tnfsf18	+	10635	18104
chr1	163586653	163587824	1171	chr1	163656373	163657620	Gm15429	-	1247	68549
chr1	163623232	163625158	1926	chr1	163656373	163657620	Gm15429	-	1247	31215
chr1	163663962	163666024	2062	chr1	163656373	163657620	Gm15429	-	1247	6342
chr1	163691103	163692232	1129	chr1	163710820	163718626	Fasl	-	7806	18588
chr1	163696123	163698364	2241	chr1	163710820	163718626	Fasl	-	7806	12456
chr1	163724520	163725520	1000	chr1	163710820	163718626	Fasl	-	7806	5894
chr1	163728078	163730433	2355	chr1	163710820	163718626	Fasl	-	7806	9452
chr1	163738535	163740145	1610	chr1	163746243	163806792	AI848100	-	60549	6098
chr1	163823236	163824497	1261	chr1	163746243	163806792	AI848100	-	60549	16444
chr1	163824832	163827121	2289	chr1	163746243	163806792	AI848100	-	60549	18040
chr1	163839216	163840216	1000	chr1	163872217	163909767	4930558K02Rik	-	37550	32001
chr1	163848120	163849597	1477	chr1	163872217	163909767	4930558K02Rik	-	37550	22620
chr1	163851610	163853807	2197	chr1	163872217	163909767	4930558K02Rik	-	37550	18410
chr1	166501150	166503111	1961	chr1	166433438	166445013	Gm16608	+	11575	56137
chr1	166811221	166813778	2557	chr1	166861775	166865658	Xcl1	-	3883	47997
chr1	166888849	166890952	2103	chr1	166861775	166865658	Xcl1	-	3883	23191
chr1	167130145	167131145	1000	chr1	167104472	167124564	Sft2d2	-	20092	5581
chr1	167654179	167655179	1000	chr1	167579076	167638225	Rcsd1	-	59149	15954
chr1	167665658	167666764	1106	chr1	167693877	167705439	Creg1	+	11562	27113
chr1	167977485	167979163	1678	chr1	167933089	167968389	Gm17444	+	35300	9096
chr1	172200203	172201221	1018	chr1	172207507	172216900	Sh2d1b1	+	9393	6286
chr1	172826467	172827512	1045	chr1	172837404	172843072	Fcrlb	-	5668	9892
chr1	172828069	172829563	1494	chr1	172837404	172843072	Fcrlb	-	5668	7841
chr1	172868843	172870331	1488	chr1	172847707	172857714	Fcrla	-	10007	11129
chr1	172879000	172880953	1953	chr1	172890689	172906678	Fcgr2b	-	15989	9736
chr1	172912170	172913826	1656	chr1	172890689	172906678	Fcgr2b	-	15989	5492
chr1	172922883	172923978	1095	chr1	172890689	172906678	Fcgr2b	-	15989	16205
chr1	172927115	172929098	1983	chr1	172949051	172959892	Fcgr4	+	10841	19953
chr1	172935120	172936935	1815	chr1	172949051	172959892	Fcgr4	+	10841	12116
chr1	172967455	172969650	2195	chr1	172949051	172959892	Fcgr4	+	10841	7563
chr1	172974136	172976120	1984	chr1	172981300	172995066	Fcgr3	-	13766	5180
chr1	173031781	173034426	2645	chr1	173044049	173057098	1700009P17Rik	+	13049	9623
chr1	173470905	173471905	1000	chr1	173448253	173465425	Itln1	-	17172	5480
chr1	173480945	173482958	2013	chr1	173489324	173515449	Cd244	+	26125	6366
chr1	173548657	173550591	1934	chr1	173518755	173537541	Ly9	-	18786	11116
chr1	173587726	173589597	1871	chr1	173562534	173579149	Slamf7	-	16615	8577
chr1	173755024	173756024	1000	chr1	173769828	173820849	Cd84	+	51021	13804
chr1	173885095	173888588	3493	chr1	173847646	173879083	Slamf6	+	31437	6012
chr1	173896100	173897417	1317	chr1	173847646	173879083	Slamf6	+	31437	17017
chr1	173905317	173907863	2546	chr1	173931091	173958575	Vangl2	-	27484	23228
chr1	174320349	174321349	1000	chr1	174306662	174314230	Pigm	+	7568	6119
chr1	174363281	174364904	1623	chr1	174405489	174408706	Slamf9	+	3217	40585
chr1	174384829	174386883	2054	chr1	174405489	174408706	Slamf9	+	3217	18606
chr1	175440686	175441901	1215	chr1	175449848	175466088	BC094916	-	16240	7947
chr1	179216482	179217543	1061	chr1	178950204	179188334	Akt3	-	238130	28148
chr1	179251510	179253619	2109	chr1	178950204	179188334	Akt3	-	238130	63176
chr1	179273182	179275088	1906	chr1	179359178	179373401	Gm17407	-	14223	84090
chr1	179385964	179387575	1611	chr1	179374792	179380891	Zfp238	+	6099	5073
chr1	179396519	179399190	2671	chr1	179374792	179380891	Zfp238	+	6099	15628
chr1	179414153	179415928	1775	chr1	179374792	179380891	Zfp238	+	6099	33262
chr1	179418604	179422231	3627	chr1	179374792	179380891	Zfp238	+	6099	37713
chr1	179485567	179486920	1353	chr1	179374792	179380891	Zfp238	+	6099	104676
chr1	179581392	179583540	2148	chr1	179659945	179683455	1700016C15Rik	+	23510	76405
chr1	179597000	179598442	1442	chr1	179659945	179683455	1700016C15Rik	+	23510	61503
chr1	179632442	179633467	1025	chr1	179659945	179683455	1700016C15Rik	+	23510	26478
chr1	179912632	179914262	1630	chr1	179921566	179978422	Gm16432	+	56856	7304
chr1	180298448	180300231	1783	chr1	180279677	180279831	Gm17323	+	154	18617
chr1	182209058	182210448	1390	chr1	182157135	182193569	Psen2	-	36434	15489
chr1	182225717	182226949	1232	chr1	182257102	182260681	Gm5069	-	3579	30153
chr1	182232824	182234260	1436	chr1	182257102	182260681	Gm5069	-	3579	22842
chr1	182443416	182445090	1674	chr1	182362518	182413598	6330403A02Rik	-	51080	29818
chr1	182449099	182450688	1589	chr1	182362518	182413598	6330403A02Rik	-	51080	35501
chr1	182470902	182473381	2479	chr1	182499086	182531384	Parp1	+	32298	25705
chr1	182475585	182478466	2881	chr1	182499086	182531384	Parp1	+	32298	20620
chr1	182700975	182702461	1486	chr1	182656174	182684334	Acbd3	+	28160	16641
chr1	182707515	182708782	1267	chr1	182730963	182744074	H3f3a	-	13111	22181
chr1	182753567	182755844	2277	chr1	182743907	182746990	Gm16067	+	3083	6577
chr1	182756082	182757082	1000	chr1	182762900	182763007	U6	+	107	5818
chr1	182813861	182816557	2696	chr1	182823239	182829234	Lefty2	+	5995	6682
chr1	182851771	182853364	1593	chr1	182865153	182868531	Lefty1	+	3378	11789
chr1	183545722	183546722	1000	chr1	183439764	183441582	Ccdc121	-	1818	104140
chr1	183789379	183792274	2895	chr1	183781739	183783320	Gm5533	-	1581	6059
chr1	183811193	183812193	1000	chr1	183834576	183950111	Enah	-	115535	22383
chr1	184153899	184155962	2063	chr1	184205903	184212935	Degs1	-	7032	49941
chr1	184184714	184186114	1400	chr1	184205903	184212935	Degs1	-	7032	19789
chr1	184458066	184459066	1000	chr1	184397391	184447655	Capn2	-	50264	10411
chr1	184468860	184470048	1188	chr1	184397391	184447655	Capn2	-	50264	21205
chr1	185625975	185629348	3373	chr1	185505657	185506073	Gm8214	-	416	119902
chr1	185689354	185693113	3759	chr1	185837181	185899515	Dusp10	+	62334	144068
chr1	185710371	185711402	1031	chr1	185837181	185899515	Dusp10	+	62334	125779
chr1	185756895	185758106	1211	chr1	185837181	185899515	Dusp10	+	62334	79075
chr1	185787393	185788538	1145	chr1	185837181	185899515	Dusp10	+	62334	48643
chr1	185802080	185804825	2745	chr1	185837181	185899515	Dusp10	+	62334	32356
chr1	185804949	185807086	2137	chr1	185837181	185899515	Dusp10	+	62334	30095
chr1	185924449	185926140	1691	chr1	185837181	185899515	Dusp10	+	62334	24934
chr1	186004460	186007372	2912	chr1	185837181	185899515	Dusp10	+	62334	104945
chr1	186014633	186015633	1000	chr1	185837181	185899515	Dusp10	+	62334	115118
chr1	186264444	186266120	1676	chr1	186403988	186404085	U6	-	97	137868
chr1	186303673	186305681	2008	chr1	186403988	186404085	U6	-	97	98307
chr1	186357779	186360236	2457	chr1	186403988	186404085	U6	-	97	43752
chr1	186385789	186387734	1945	chr1	186403988	186404085	U6	-	97	16254
chr1	186482379	186484883	2504	chr1	186441127	186441609	Rpl21-ps1	+	482	40770
chr1	189200651	189202415	1764	chr1	189039387	189175583	Gpatch2	+	136196	25068
chr1	189394899	189395899	1000	chr1	189432670	190038764	Esrrg	+	606094	36771
chr1	191428588	191430697	2109	chr1	191464478	191511965	Cenpf	-	47487	33781
chr1	191526993	191528004	1011	chr1	191464478	191511965	Cenpf	-	47487	15028
chr1	192942658	192943738	1080	chr1	192922293	192932822	Batf3	+	10529	9836
chr1	192946570	192948693	2123	chr1	192922293	192932822	Batf3	+	10529	13748
chr1	193071684	193074319	2635	chr1	193048353	193049565	D730003I15Rik	+	1212	22119
chr1	193100679	193103178	2499	chr1	193130668	193142073	Nenf	-	11405	27490
chr1	193281451	193283064	1613	chr1	193175860	193220920	Ppp2r5a	-	45060	60531
chr1	193303430	193304689	1259	chr1	193361244	193399413	Dtl	-	38169	56555
chr1	193484918	193487220	2302	chr1	193399642	193446551	Ints7	+	46909	38367
chr1	193624866	193629212	4346	chr1	193645323	193656929	Nek2	+	11606	16111
chr1	193636280	193637588	1308	chr1	193645323	193656929	Nek2	+	11606	7735
chr1	193779681	193781039	1358	chr1	193801270	193810273	Rd3	+	9003	20231
chr1	195208494	195209527	1033	chr1	195172540	195196491	Camk1g	-	23951	12003
chr1	196705582	196706642	1060	chr1	196684851	196685144	7SK	+	293	20438
chr1	197010301	197012165	1864	chr1	196963005	197002909	Cr2	-	39904	7392
chr1	197025967	197027505	1538	chr1	196963005	197002909	Cr2	-	39904	23058
chr1	197027833	197030121	2288	chr1	197054472	197054592	AC109145.1	+	120	24351
chr1	197036969	197037969	1000	chr1	197054472	197054592	AC109145.1	+	120	16503
chr1	197067423	197068429	1006	chr1	197054472	197054592	AC109145.1	+	120	12831
chr1	6396414	6397414	1000	chr1	6349537	6384812	Fam150a	+	35275	11602
chr1	14586081	14587081	1000	chr1	14743427	14746047	Msc	-	2620	156346
chr1	16540018	16541598	1580	chr1	16559863	16609570	Ube2w	-	49707	18265
chr1	16736285	16738383	2098	chr1	16757095	16760241	Gm5828	-	3146	18712
chr1	35676303	35677303	1000	chr1	35818447	35818551	U6	+	104	141144
chr1	35870346	35871646	1300	chr1	35818447	35818551	U6	+	104	51795
chr1	36356432	36357479	1047	chr1	36364578	36380874	Arid5a	+	16296	7099
chr1	37657383	37658444	1061	chr1	37668522	37776930	2010300C02Rik	-	108408	10078
chr1	39792365	39793544	1179	chr1	39722151	39777842	Rfx8	-	55691	14523
chr1	39818278	39819278	1000	chr1	39722151	39777842	Rfx8	-	55691	40436
chr1	39899464	39901264	1800	chr1	39861028	39861189	Gm3646	-	161	38275
chr1	51506024	51507083	1059	chr1	51526342	51535243	Obfc2a	-	8901	19259
chr1	51575061	51576580	1519	chr1	51526342	51535243	Obfc2a	-	8901	39818
chr1	51991341	51992374	1033	chr1	51997494	51998105	Gm8420	-	611	5120
chr1	52355207	52356355	1148	chr1	52220292	52290076	Gls	-	69784	65131
chr1	53848147	53849347	1200	chr1	53812350	53842068	Stk17b	-	29718	6079
chr1	54642234	54644634	2400	chr1	54537550	54614526	Pgap1	-	76976	27708
chr1	55001677	55002794	1117	chr1	54702184	54983231	Ankrd44	-	281047	18446
chr1	60997292	60999486	2194	chr1	61005074	61005309	Gm11582	-	235	5588
chr1	65024591	65025909	1318	chr1	65040498	65041205	Rpl10a-ps1	-	707	14589
chr1	74863241	74864281	1040	chr1	74838090	74850753	Wnt10a	+	12663	12488
chr1	80851966	80852999	1033	chr1	80497648	80755128	Dock10	-	257480	96838
chr1	82815484	82816644	1160	chr1	82836021	82836073	AC138214.1	+	52	19377
chr1	82828335	82830204	1869	chr1	82836021	82836073	AC138214.1	+	52	5817
chr1	88337930	88340167	2237	chr1	88322946	88324538	1700019O17Rik	+	1592	13392
chr1	88400468	88403634	3166	chr1	88423311	88427273	Ptma	+	3962	19677
chr1	89504030	89505173	1143	chr1	89406464	89494420	Neu2	+	87956	9610
chr1	103798518	103800363	1845	chr1	104003026	104003157	SNORA17	-	131	202663
chr1	108049317	108050327	1010	chr1	108068329	108290827	Phlpp1	+	222498	18002
chr1	108060068	108061959	1891	chr1	108068329	108290827	Phlpp1	+	222498	6370
chr1	127363069	127364165	1096	chr1	127289483	127332067	Actr3	-	42584	31002
chr1	127364511	127365511	1000	chr1	127289483	127332067	Actr3	-	42584	32444
chr1	129755059	129756388	1329	chr1	129765350	129840445	Rab3gap1	+	75095	8962
chr1	130334920	130335920	1000	chr1	130260285	130313993	Dars	-	53708	20927
chr1	130445254	130446287	1033	chr1	130411692	130411796	U6	-	104	33458
chr1	130504702	130505702	1000	chr1	130484776	130488870	Cxcr4	-	4094	15832
chr1	133006854	133008301	1447	chr1	132998970	132999322	7SK	-	352	7532
chr1	133451773	133452773	1000	chr1	133424480	133436449	Fam72a	+	11969	15324
chr1	134161546	134163160	1614	chr1	134088013	134153958	Lemd1	+	65945	7588
chr1	135712198	135713337	1139	chr1	135599255	135697618	Atp2b4	-	98363	14580
chr1	135752489	135754366	1877	chr1	135793773	135804576	Optc	-	10803	39407
chr1	135959733	135960825	1092	chr1	135971747	135975697	Btg2	-	3950	10922
chr1	137114438	137115438	1000	chr1	137129022	137129801	Gm4204	+	779	13584
chr1	138434116	138435116	1000	chr1	138364535	138428088	Kif14	+	63553	6028
chr1	138581900	138582983	1083	chr1	138592788	138622305	Gm16880	+	29517	9805
chr1	140224072	140225072	1000	chr1	140170315	140186037	Atp6v1g3	+	15722	38035
chr1	146130242	146131242	1000	chr1	146091102	146096372	Rgs1	-	5270	33870
chr1	152848813	152849813	1000	chr1	152410657	152840565	Hmcn1	-	429908	8248
chr1	155261404	155262429	1025	chr1	155251957	155255726	E330020D12Rik	-	3769	5678
chr1	156698711	156700013	1302	chr1	156239649	156573049	Cacna1e	-	333400	125662
chr1	156731362	156732362	1000	chr1	156239649	156573049	Cacna1e	-	333400	158313
chr1	156875776	156876998	1222	chr1	156910653	156930396	Gm9530	-	19743	33655
chr1	156897517	156898690	1173	chr1	156910653	156930396	Gm9530	-	19743	11963
chr1	156955390	156957677	2287	chr1	156943497	156946766	Ier5	-	3269	8624
chr1	158926522	158927653	1131	chr1	158734297	158869757	Ralgps2	-	135460	56765
chr1	159005436	159006436	1000	chr1	159029279	159038811	1700057K13Rik	-	9532	22843
chr1	163837385	163838385	1000	chr1	163746243	163806792	AI848100	-	60549	30593
chr1	166800815	166801815	1000	chr1	166726863	166754397	Dpt	+	27534	46418
chr1	167572143	167573197	1054	chr1	167579076	167638225	Rcsd1	-	59149	5879
chr1	167648180	167649369	1189	chr1	167579076	167638225	Rcsd1	-	59149	9955
chr1	168661044	168662044	1000	chr1	168692276	168700616	Gm4954	+	8340	30232
chr1	173757946	173759024	1078	chr1	173769828	173820849	Cd84	+	51021	10804
chr1	173912305	173914020	1715	chr1	173931091	173958575	Vangl2	-	27484	17071
chr1	174443350	174444490	1140	chr1	174430178	174437511	Tagln2	+	7333	5839
chr1	179268637	179269644	1007	chr1	178950204	179188334	Akt3	-	238130	80303
chr1	182244406	182245406	1000	chr1	182257102	182260681	Gm5069	-	3579	11696
chr1	182697828	182699091	1263	chr1	182656174	182684334	Acbd3	+	28160	13494
chr1	182805284	182806284	1000	chr1	182781282	182798228	BC031781	+	16946	7056
chr1	183186900	183192203	5303	chr1	183172076	183172498	Rpl35a-ps2	-	422	14402
chr1	185493432	185494432	1000	chr1	185505657	185506073	Gm8214	-	416	11225
chr1	185829420	185830459	1039	chr1	185837181	185899515	Dusp10	+	62334	6722
chr1	186084529	186085600	1071	chr1	185837181	185899515	Dusp10	+	62334	185014
chr1	186366176	186367264	1088	chr1	186403988	186404085	U6	-	97	36724
chr1	191431800	191433816	2016	chr1	191464478	191511965	Cenpf	-	47487	30662
chr1	193638360	193639555	1195	chr1	193645323	193656929	Nek2	+	11606	5768
chr1	193785124	193786143	1019	chr1	193801270	193810273	Rd3	+	9003	15127
chr10	3282073	3284821	2748	chr10	3294063	3460745	Ipcef1	+	166682	9242
chr10	3285721	3286721	1000	chr10	3294063	3460745	Ipcef1	+	166682	7342
chr10	5743817	5745992	2175	chr10	5340927	5734948	Esr1	-	394021	8869
chr10	6700348	6701348	1000	chr10	6791664	6806301	Iyd	-	14637	90316
chr10	7108524	7109729	1205	chr10	7078791	7088611	H60c	+	9820	19913
chr10	7599631	7600631	1000	chr10	7552268	7590195	Zc3h12d	+	37927	9436
chr10	7727001	7728238	1237	chr10	7625451	7676028	Tab2	-	50577	50973
chr10	7757186	7758186	1000	chr10	7625451	7676028	Tab2	-	50577	81158
chr10	7784965	7786773	1808	chr10	7625451	7676028	Tab2	-	50577	108937
chr10	7849638	7851836	2198	chr10	7924551	8238623	Ust	-	314072	72715
chr10	7855945	7856945	1000	chr10	7924551	8238623	Ust	-	314072	67606
chr10	8631178	8633099	1921	chr10	8604392	8606678	Gm17280	+	2286	24500
chr10	8644521	8646550	2029	chr10	8604392	8606678	Gm17280	+	2286	37843
chr10	8653731	8656798	3067	chr10	8604392	8606678	Gm17280	+	2286	47053
chr10	8672052	8673708	1656	chr10	8604392	8606678	Gm17280	+	2286	65374
chr10	8674951	8676063	1112	chr10	8604392	8606678	Gm17280	+	2286	68273
chr10	9903622	9905638	2016	chr10	9820751	9820914	U1	+	163	82708
chr10	12594507	12595691	1184	chr10	12101986	12589163	Utrn	-	487177	5344
chr10	12607541	12609196	1655	chr10	12101986	12589163	Utrn	-	487177	18378
chr10	12694595	12697897	3302	chr10	12659787	12684065	Stx11	-	24278	10530
chr10	13666210	13667268	1058	chr10	13686185	13871182	Hivep2	+	184997	18917
chr10	13927322	13928601	1279	chr10	13953319	13953429	SNORA17	+	110	24718
chr10	16217938	16219777	1839	chr10	16836610	16836706	U6	+	96	616833
chr10	16713729	16717716	3987	chr10	16836610	16836706	U6	+	96	118894
chr10	16730128	16733230	3102	chr10	16836610	16836706	U6	+	96	103380
chr10	16919876	16922118	2242	chr10	16836610	16836706	U6	+	96	83170
chr10	16934662	16935742	1080	chr10	16836610	16836706	U6	+	96	97956
chr10	16950713	16951713	1000	chr10	16836610	16836706	U6	+	96	114007
chr10	17067345	17068623	1278	chr10	16836610	16836706	U6	+	96	230639
chr10	17135051	17136249	1198	chr10	16836610	16836706	U6	+	96	298345
chr10	17137607	17138781	1174	chr10	16836610	16836706	U6	+	96	300901
chr10	17241242	17242874	1632	chr10	17443034	17445479	Cited2	+	2445	200160
chr10	17258485	17261455	2970	chr10	17443034	17445479	Cited2	+	2445	181579
chr10	17267952	17271720	3768	chr10	17443034	17445479	Cited2	+	2445	171314
chr10	17279828	17280828	1000	chr10	17443034	17445479	Cited2	+	2445	162206
chr10	17284483	17285780	1297	chr10	17443034	17445479	Cited2	+	2445	157254
chr10	17286064	17287829	1765	chr10	17443034	17445479	Cited2	+	2445	155205
chr10	17308334	17310721	2387	chr10	17443034	17445479	Cited2	+	2445	132313
chr10	17349025	17350599	1574	chr10	17443034	17445479	Cited2	+	2445	92435
chr10	17372601	17373601	1000	chr10	17443034	17445479	Cited2	+	2445	69433
chr10	17374957	17376089	1132	chr10	17443034	17445479	Cited2	+	2445	66945
chr10	17395566	17397359	1793	chr10	17443034	17445479	Cited2	+	2445	45675
chr10	17452776	17453776	1000	chr10	17443034	17445479	Cited2	+	2445	7297
chr10	17468929	17471402	2473	chr10	17443034	17445479	Cited2	+	2445	23450
chr10	17491654	17492786	1132	chr10	17512912	17519727	RP24-309I5.3	-	6815	20126
chr10	17494064	17496038	1974	chr10	17512912	17519727	RP24-309I5.3	-	6815	16874
chr10	17708298	17709836	1538	chr10	17731069	17743058	3110003A17Rik	-	11989	21233
chr10	17916643	17917656	1013	chr10	17933482	17954804	Ccdc28a	-	21322	15826
chr10	18636687	18638645	1958	chr10	18564877	18576879	Perp	+	12002	59808
chr10	18642783	18643937	1154	chr10	18564877	18576879	Perp	+	12002	65904
chr10	18647041	18648041	1000	chr10	18564877	18576879	Perp	+	12002	70162
chr10	18672141	18673979	1838	chr10	18720716	18735463	Tnfaip3	-	14747	46737
chr10	18684042	18685738	1696	chr10	18720716	18735463	Tnfaip3	-	14747	34978
chr10	18698675	18702360	3685	chr10	18720716	18735463	Tnfaip3	-	14747	18356
chr10	18702627	18704213	1586	chr10	18720716	18735463	Tnfaip3	-	14747	16503
chr10	18706532	18707601	1069	chr10	18720716	18735463	Tnfaip3	-	14747	13115
chr10	18710161	18711304	1143	chr10	18720716	18735463	Tnfaip3	-	14747	9412
chr10	18744206	18745206	1000	chr10	18720716	18735463	Tnfaip3	-	14747	8743
chr10	18763003	18764185	1182	chr10	18720716	18735463	Tnfaip3	-	14747	27540
chr10	18772661	18774504	1843	chr10	18720716	18735463	Tnfaip3	-	14747	37198
chr10	18780894	18781894	1000	chr10	18720716	18735463	Tnfaip3	-	14747	45431
chr10	18786396	18789100	2704	chr10	18720716	18735463	Tnfaip3	-	14747	50933
chr10	18796909	18798378	1469	chr10	18720716	18735463	Tnfaip3	-	14747	61446
chr10	18813525	18814961	1436	chr10	18720716	18735463	Tnfaip3	-	14747	78062
chr10	18824386	18825386	1000	chr10	18720716	18735463	Tnfaip3	-	14747	88923
chr10	18837631	18839195	1564	chr10	18720716	18735463	Tnfaip3	-	14747	102168
chr10	18886876	18889033	2157	chr10	18720716	18735463	Tnfaip3	-	14747	151413
chr10	18895260	18898252	2992	chr10	18720716	18735463	Tnfaip3	-	14747	159797
chr10	18902133	18906659	4526	chr10	18720716	18735463	Tnfaip3	-	14747	166670
chr10	18907103	18908806	1703	chr10	19076366	19078412	Olig3	+	2046	167560
chr10	18928899	18930775	1876	chr10	19076366	19078412	Olig3	+	2046	145591
chr10	18935953	18936953	1000	chr10	19076366	19078412	Olig3	+	2046	139413
chr10	19303540	19304679	1139	chr10	19311755	19330035	Ifngr1	+	18280	7076
chr10	19387803	19389990	2187	chr10	19364556	19380607	9230106D20Rik	+	16051	7196
chr10	19411090	19413100	2010	chr10	19432393	19479859	Il20ra	+	47466	19293
chr10	19633055	19634055	1000	chr10	19579735	19627495	Pex7	-	47760	5560
chr10	20010090	20011191	1101	chr10	19868277	20001393	Mtap7	+	133116	8697
chr10	20489349	20491565	2216	chr10	20117810	20444884	Pde7b	-	327074	44465
chr10	20491779	20492779	1000	chr10	20117810	20444884	Pde7b	-	327074	46895
chr10	20554325	20556063	1738	chr10	20117810	20444884	Pde7b	-	327074	109441
chr10	20602178	20603352	1174	chr10	20672391	20800234	Ahi1	+	127843	69039
chr10	20626303	20627303	1000	chr10	20672391	20800234	Ahi1	+	127843	45088
chr10	20818536	20820943	2407	chr10	20672391	20800234	Ahi1	+	127843	18302
chr10	20821649	20823473	1824	chr10	20844736	20880790	Myb	-	36054	21263
chr10	20832183	20834033	1850	chr10	20844736	20880790	Myb	-	36054	10703
chr10	20897266	20899119	1853	chr10	20844736	20880790	Myb	-	36054	16476
chr10	20905815	20910211	4396	chr10	20844736	20880790	Myb	-	36054	25025
chr10	20911608	20912729	1121	chr10	20844736	20880790	Myb	-	36054	30818
chr10	20919409	20921124	1715	chr10	20945696	20945776	AC153556.1	+	80	24572
chr10	20954253	20955978	1725	chr10	20945696	20945776	AC153556.1	+	80	8477
chr10	21187472	21190290	2818	chr10	21145110	21145552	1700021A07Rik	+	442	41920
chr10	21254634	21256580	1946	chr10	21308183	21308282	snoU13	+	99	51603
chr10	21279175	21280175	1000	chr10	21308183	21308282	snoU13	+	99	28008
chr10	21285249	21286249	1000	chr10	21308183	21308282	snoU13	+	99	21934
chr10	21436240	21438199	1959	chr10	21410651	21413784	Gm5420	+	3133	22456
chr10	21496133	21497276	1143	chr10	21550305	21564657	Gm6846	-	14352	53029
chr10	22017111	22018289	1178	chr10	21878392	22008655	H60b	+	130263	8456
chr10	22020298	22024546	4248	chr10	21878392	22008655	H60b	+	130263	11643
chr10	22027618	22028928	1310	chr10	21878392	22008655	H60b	+	130263	18963
chr10	25037509	25039331	1822	chr10	24888896	25027676	Akap7	-	138780	9833
chr10	25050728	25052507	1779	chr10	24888896	25027676	Akap7	-	138780	23052
chr10	30222008	30223830	1822	chr10	30213748	30213854	U6	+	106	8154
chr10	33974655	33975655	1000	chr10	34001996	34004691	Tspyl1	+	2695	26341
chr10	35557871	35560153	2282	chr10	35428497	35431697	Amd2	-	3200	126174
chr10	36655148	36656148	1000	chr10	36694350	36721695	Hdac2	+	27345	38202
chr10	36909301	36910423	1122	chr10	36859364	36861485	5930403N24Rik	+	2121	47816
chr10	36950832	36953244	2412	chr10	36859364	36861485	5930403N24Rik	+	2121	89347
chr10	36955614	36957153	1539	chr10	36859364	36861485	5930403N24Rik	+	2121	94129
chr10	37009412	37010966	1554	chr10	37057292	37099458	Gm16988	+	42166	46326
chr10	37039783	37040969	1186	chr10	37057292	37099458	Gm16988	+	42166	16323
chr10	37041606	37042689	1083	chr10	37057292	37099458	Gm16988	+	42166	14603
chr10	37116881	37117881	1000	chr10	37057292	37099458	Gm16988	+	42166	17423
chr10	37429426	37431097	1671	chr10	37651486	37651586	AC155948.1	+	100	220389
chr10	37727988	37728990	1002	chr10	37651486	37651586	AC155948.1	+	100	76402
chr10	37760062	37765048	4986	chr10	37651486	37651586	AC155948.1	+	100	108476
chr10	37771864	37772982	1118	chr10	37651486	37651586	AC155948.1	+	100	120278
chr10	38343171	38344171	1000	chr10	38335181	38335287	U6	-	106	7884
chr10	38599995	38600995	1000	chr10	38685321	38829994	Lama4	+	144673	84326
chr10	38890185	38891874	1689	chr10	38870777	38883600	Wisp3	-	12823	6585
chr10	38985754	38986890	1136	chr10	39088661	39285187	Fyn	+	196526	101771
chr10	39030599	39032376	1777	chr10	39088661	39285187	Fyn	+	196526	56285
chr10	39058736	39060644	1908	chr10	39088661	39285187	Fyn	+	196526	28017
chr10	39882632	39886122	3490	chr10	39753341	39862062	Slc16a10	-	108721	20570
chr10	39890266	39892338	2072	chr10	39753341	39862062	Slc16a10	-	108721	28204
chr10	40030019	40031078	1059	chr10	40007265	40021992	Amd1	-	14727	8027
chr10	40234783	40235783	1000	chr10	40069114	40203624	Cdk19	+	134510	31159
chr10	40244666	40246427	1761	chr10	40069114	40203624	Cdk19	+	134510	41042
chr10	42564920	42566412	1492	chr10	42481302	42552320	Sec63	+	71018	12600
chr10	43361555	43363340	1785	chr10	43313233	43350722	F930017D23Rik	+	37489	10833
chr10	43421819	43423644	1825	chr10	43313233	43350722	F930017D23Rik	+	37489	71097
chr10	43425570	43428725	3155	chr10	43313233	43350722	F930017D23Rik	+	37489	74848
chr10	43442728	43444026	1298	chr10	43313233	43350722	F930017D23Rik	+	37489	92006
chr10	43459103	43460747	1644	chr10	43541037	43542044	Gm9034	+	1007	80290
chr10	43461542	43462685	1143	chr10	43541037	43542044	Gm9034	+	1007	78352
chr10	43464972	43466885	1913	chr10	43541037	43542044	Gm9034	+	1007	74152
chr10	43470263	43472715	2452	chr10	43541037	43542044	Gm9034	+	1007	68322
chr10	43477071	43480541	3470	chr10	43541037	43542044	Gm9034	+	1007	60496
chr10	43549541	43550541	1000	chr10	43541037	43542044	Gm9034	+	1007	7497
chr10	43788444	43789629	1185	chr10	43670113	43724652	Aim1	-	54539	63792
chr10	44094326	44095909	1583	chr10	43988164	44084097	Atg5	+	95933	10229
chr10	44096341	44098544	2203	chr10	43988164	44084097	Atg5	+	95933	12244
chr10	44099567	44100690	1123	chr10	43988164	44084097	Atg5	+	95933	15470
chr10	44119617	44120617	1000	chr10	43988164	44084097	Atg5	+	95933	35520
chr10	44258546	44260000	1454	chr10	44156983	44248307	Prdm1	-	91324	10239
chr10	44350071	44352226	2155	chr10	44317046	44317133	U6	-	87	32938
chr10	44423170	44425074	1904	chr10	44452159	44452273	U6	+	114	27085
chr10	44427371	44429575	2204	chr10	44452159	44452273	U6	+	114	22584
chr10	45519456	45520456	1000	chr10	45297635	45432151	Hace1	+	134516	87305
chr10	45540595	45541949	1354	chr10	45297635	45432151	Hace1	+	134516	108444
chr10	53098564	53100052	1488	chr10	53016060	53068936	Gm9766	-	52876	29628
chr10	53117728	53118871	1143	chr10	53016060	53068936	Gm9766	-	52876	48792
chr10	53245392	53248316	2924	chr10	53256135	53350245	Mcm9	-	94110	7819
chr10	53532204	53533204	1000	chr10	53352951	53470715	Fam184a	-	117764	61489
chr10	53836812	53838706	1894	chr10	53795728	53800887	Gm16998	+	5159	35925
chr10	53855646	53856646	1000	chr10	53795728	53800887	Gm16998	+	5159	54759
chr10	53963766	53965189	1423	chr10	54031031	54031137	U6	-	106	65842
chr10	53974081	53976077	1996	chr10	54031031	54031137	U6	-	106	54954
chr10	56759361	56761989	2628	chr10	56893836	56893935	U6	+	99	131847
chr10	58698544	58699631	1087	chr10	58684701	58689179	Sowahc	+	4478	9365
chr10	59099258	59100331	1073	chr10	58909732	59079440	Ccdc109a	-	169708	19818
chr10	59155217	59156217	1000	chr10	59165225	59326880	Micu1	+	161655	9008
chr10	59369004	59370004	1000	chr10	59342304	59362050	Dnajb12	+	19746	6954
chr10	59372813	59374917	2104	chr10	59342304	59362050	Dnajb12	+	19746	10763
chr10	59382761	59384561	1800	chr10	59342304	59362050	Dnajb12	+	19746	20711
chr10	59394754	59396538	1784	chr10	59412423	59414518	Ddit4	-	2095	15885
chr10	59396638	59399633	2995	chr10	59412423	59414518	Ddit4	-	2095	12790
chr10	59400628	59403198	2570	chr10	59412423	59414518	Ddit4	-	2095	9225
chr10	59404412	59407229	2817	chr10	59412423	59414518	Ddit4	-	2095	5194
chr10	59435903	59437991	2088	chr10	59450657	59465860	Anapc16	-	15203	12666
chr10	59442905	59444089	1184	chr10	59450657	59465860	Anapc16	-	15203	6568
chr10	59610824	59611988	1164	chr10	59568967	59597946	Spock2	+	28979	12878
chr10	59612085	59615147	3062	chr10	59568967	59597946	Spock2	+	28979	14139
chr10	59692593	59694561	1968	chr10	59704457	59704547	AC155640.2	+	90	9896
chr10	59713258	59714407	1149	chr10	59704457	59704547	AC155640.2	+	90	8711
chr10	59714452	59717098	2646	chr10	59704457	59704547	AC155640.2	+	90	9905
chr10	59722234	59725622	3388	chr10	59740375	59765345	Psap	+	24970	14753
chr10	60167892	60169563	1671	chr10	60174820	60215542	Slc29a3	-	40722	5257
chr10	66314579	66316944	2365	chr10	66375237	66383006	1110002J07Rik	-	7769	58293
chr10	66319883	66321206	1323	chr10	66375237	66383006	1110002J07Rik	-	7769	54031
chr10	66392824	66396457	3633	chr10	66383650	66386347	Gm17351	+	2697	6477
chr10	66399697	66400882	1185	chr10	66383650	66386347	Gm17351	+	2697	13350
chr10	66413235	66414235	1000	chr10	66383650	66386347	Gm17351	+	2697	26888
chr10	66418309	66420772	2463	chr10	66383650	66386347	Gm17351	+	2697	31962
chr10	66460890	66462022	1132	chr10	66474256	66559605	Reep3	-	85349	12234
chr10	66759105	66760241	1136	chr10	66729437	66748053	Nrbf2	-	18616	11052
chr10	66773864	66774992	1128	chr10	66729437	66748053	Nrbf2	-	18616	25811
chr10	66945408	66947313	1905	chr10	66998223	67004936	Egr2	+	6713	50910
chr10	66951902	66953630	1728	chr10	66998223	67004936	Egr2	+	6713	44593
chr10	66959411	66961278	1867	chr10	66998223	67004936	Egr2	+	6713	36945
chr10	66967440	66968440	1000	chr10	66998223	67004936	Egr2	+	6713	29783
chr10	66986114	66989276	3162	chr10	66998223	67004936	Egr2	+	6713	8947
chr10	67044518	67045518	1000	chr10	67034790	67037011	Gm10797	+	2221	7507
chr10	67048194	67050044	1850	chr10	67034790	67037011	Gm10797	+	2221	11183
chr10	67060745	67062543	1798	chr10	67034790	67037011	Gm10797	+	2221	23734
chr10	67063381	67064626	1245	chr10	67034790	67037011	Gm10797	+	2221	26370
chr10	67069458	67071096	1638	chr10	67034790	67037011	Gm10797	+	2221	32447
chr10	67072889	67074398	1509	chr10	67034790	67037011	Gm10797	+	2221	35878
chr10	67082550	67083638	1088	chr10	67034790	67037011	Gm10797	+	2221	45539
chr10	67094991	67095991	1000	chr10	67034790	67037011	Gm10797	+	2221	57980
chr10	67096282	67098767	2485	chr10	67034790	67037011	Gm10797	+	2221	59271
chr10	67099275	67100405	1130	chr10	67034790	67037011	Gm10797	+	2221	62264
chr10	67106062	67107155	1093	chr10	67034790	67037011	Gm10797	+	2221	69051
chr10	67117296	67119416	2120	chr10	67034790	67037011	Gm10797	+	2221	80285
chr10	67120047	67121824	1777	chr10	67034790	67037011	Gm10797	+	2221	83036
chr10	67134987	67137172	2185	chr10	67034790	67037011	Gm10797	+	2221	97976
chr10	67141588	67142680	1092	chr10	67034790	67037011	Gm10797	+	2221	104577
chr10	67152807	67153807	1000	chr10	67034790	67037011	Gm10797	+	2221	115796
chr10	67155669	67157129	1460	chr10	67034790	67037011	Gm10797	+	2221	118658
chr10	67165311	67166540	1229	chr10	67034790	67037011	Gm10797	+	2221	128300
chr10	67179363	67180363	1000	chr10	67034790	67037011	Gm10797	+	2221	142352
chr10	67191572	67192572	1000	chr10	67034790	67037011	Gm10797	+	2221	154561
chr10	67205075	67206727	1652	chr10	67348851	67375410	Zfp365	-	26559	142124
chr10	67222750	67223873	1123	chr10	67348851	67375410	Zfp365	-	26559	124978
chr10	67763145	67764839	1694	chr10	67558341	67741474	Arid5b	-	183133	21671
chr10	67818336	67820429	2093	chr10	67893701	68004644	1700040L02Rik	-	110943	73272
chr10	67828795	67830018	1223	chr10	67893701	68004644	1700040L02Rik	-	110943	63683
chr10	67833127	67834852	1725	chr10	67893701	68004644	1700040L02Rik	-	110943	58849
chr10	67840130	67841335	1205	chr10	67893701	68004644	1700040L02Rik	-	110943	52366
chr10	68135605	68137080	1475	chr10	68186494	68245402	Tmem26	+	58908	49414
chr10	68257060	68259128	2068	chr10	68186494	68245402	Tmem26	+	58908	11658
chr10	69502020	69503644	1624	chr10	68996970	69490184	Ank3	+	493214	11836
chr10	74284471	74287165	2694	chr10	74325733	74326164	Gm6419	-	431	38568
chr10	75334973	75336439	1466	chr10	75322098	75322995	Mif	-	897	11978
chr10	75478667	75480696	2029	chr10	75417259	75472336	Gm5134	+	55077	6331
chr10	75480996	75483253	2257	chr10	75417259	75472336	Gm5134	+	55077	8660
chr10	76984579	76986534	1955	chr10	76949409	76979175	2810425M01Rik	+	29766	5404
chr10	77135813	77136813	1000	chr10	77085020	77108738	Ube2g2	+	23718	27075
chr10	77554774	77556500	1726	chr10	77532105	77546000	Icosl	+	13895	8774
chr10	77596315	77598940	2625	chr10	77624812	77632513	D10Jhu81e	-	7701	25872
chr10	77611325	77612376	1051	chr10	77624812	77632513	D10Jhu81e	-	7701	12436
chr10	77820344	77822094	1750	chr10	77731923	77815234	Agpat3	-	83311	5110
chr10	77938885	77940518	1633	chr10	77947315	77950587	Gm9978	-	3272	6797
chr10	78888258	78890003	1745	chr10	78819321	78859943	Vmn2r82	+	40622	28315
chr10	79905274	79908040	2766	chr10	79872259	79896392	Tcf3	-	24133	8882
chr10	80400166	80404218	4052	chr10	80392836	80394949	Gadd45b	+	2113	5217
chr10	81013713	81015303	1590	chr10	80991469	81007935	Gna11	-	16466	5778
chr10	81510449	81511521	1072	chr10	81521162	81524074	Zfp873	+	2912	9641
chr10	81545636	81546768	1132	chr10	81521162	81524074	Zfp873	+	2912	21562
chr10	81590331	81591449	1118	chr10	81600998	81614756	AU041133	+	13758	9549
chr10	81816621	81817668	1047	chr10	81841338	81843982	Gm4924	+	2644	23670
chr10	82243024	82244070	1046	chr10	82211446	82226889	Nfyb	-	15443	16135
chr10	82257579	82258579	1000	chr10	82274868	82286987	1700028I16Rik	+	12119	16289
chr10	82259020	82260174	1154	chr10	82274868	82286987	1700028I16Rik	+	12119	14694
chr10	82260332	82262324	1992	chr10	82274868	82286987	1700028I16Rik	+	12119	12544
chr10	82266964	82267964	1000	chr10	82274868	82286987	1700028I16Rik	+	12119	6904
chr10	82396846	82400817	3971	chr10	82417089	82417745	Gm4799	+	656	16272
chr10	82426152	82428623	2471	chr10	82417089	82417745	Gm4799	+	656	8407
chr10	83550104	83551182	1078	chr10	83833650	83903342	Nuak1	-	69692	282468
chr10	83570844	83574312	3468	chr10	83833650	83903342	Nuak1	-	69692	259338
chr10	83610154	83611154	1000	chr10	83833650	83903342	Nuak1	-	69692	222496
chr10	85290278	85291542	1264	chr10	85270560	85271990	Gm6721	+	1430	18288
chr10	87214680	87218279	3599	chr10	87289122	87326126	Gm16176	-	37004	70843
chr10	87516268	87517971	1703	chr10	87553817	87555120	Pmch	+	1303	35846
chr10	90599467	90601921	2454	chr10	90610316	90634759	Tmpo	-	24443	8395
chr10	90643409	90644409	1000	chr10	90610316	90634759	Tmpo	-	24443	8650
chr10	90650073	90651198	1125	chr10	90610316	90634759	Tmpo	-	24443	15314
chr10	90667654	90668654	1000	chr10	90690931	90691257	Gm16484	+	326	22277
chr10	92586372	92588192	1820	chr10	92623621	92729816	Cdk17	+	106195	35429
chr10	92787967	92789665	1698	chr10	92710159	92773880	Elk3	-	63721	14087
chr10	92798246	92800138	1892	chr10	92710159	92773880	Elk3	-	63721	24366
chr10	92805141	92811315	6174	chr10	92710159	92773880	Elk3	-	63721	31261
chr10	92814687	92816713	2026	chr10	92710159	92773880	Elk3	-	63721	40807
chr10	92818404	92819404	1000	chr10	92710159	92773880	Elk3	-	63721	44524
chr10	92827162	92828570	1408	chr10	92710159	92773880	Elk3	-	63721	53282
chr10	92837445	92838824	1379	chr10	92710159	92773880	Elk3	-	63721	63565
chr10	92851566	92852963	1397	chr10	92916141	92947641	Lta4h	+	31500	63178
chr10	92870746	92872232	1486	chr10	92916141	92947641	Lta4h	+	31500	43909
chr10	92894934	92895970	1036	chr10	92916141	92947641	Lta4h	+	31500	20171
chr10	93076963	93077963	1000	chr10	93052158	93067990	4933408J17Rik	+	15832	8973
chr10	93282692	93284020	1328	chr10	93294300	93311269	Usp44	+	16969	10280
chr10	94453951	94455271	1320	chr10	94411224	94411527	7SK	+	303	42424
chr10	94547654	94549540	1886	chr10	94637380	94786767	Cradd	-	149387	87840
chr10	94612991	94613991	1000	chr10	94637380	94786767	Cradd	-	149387	23389
chr10	94810530	94812337	1807	chr10	94637380	94786767	Cradd	-	149387	23763
chr10	94829734	94832007	2273	chr10	94847996	94879814	Socs2	-	31818	15989
chr10	94833939	94836621	2682	chr10	94847996	94879814	Socs2	-	31818	11375
chr10	94903206	94906158	2952	chr10	94880009	94891274	5730420D15Rik	+	11265	11932
chr10	94971238	94972238	1000	chr10	94977779	95008292	Ube2n	+	30513	5541
chr10	95169761	95171575	1814	chr10	95135625	95136085	Gm6843	-	460	33676
chr10	95184333	95185333	1000	chr10	95135625	95136085	Gm6843	-	460	48248
chr10	95207754	95209472	1718	chr10	95255205	95257614	4732465J04Rik	+	2409	45733
chr10	95216695	95218481	1786	chr10	95255205	95257614	4732465J04Rik	+	2409	36724
chr10	95279962	95280962	1000	chr10	95255205	95257614	4732465J04Rik	+	2409	22348
chr10	95304598	95307090	2492	chr10	95255205	95257614	4732465J04Rik	+	2409	46984
chr10	95308402	95310923	2521	chr10	95361237	95361369	SNORA17	+	132	50314
chr10	95312064	95314203	2139	chr10	95361237	95361369	SNORA17	+	132	47034
chr10	95342438	95343714	1276	chr10	95361237	95361369	SNORA17	+	132	17523
chr10	95374392	95379511	5119	chr10	95361237	95361369	SNORA17	+	132	13023
chr10	95542542	95544265	1723	chr10	95403297	95508152	Eea1	+	104855	34390
chr10	95556503	95557503	1000	chr10	95403297	95508152	Eea1	+	104855	48351
chr10	95566702	95568278	1576	chr10	95403297	95508152	Eea1	+	104855	58550
chr10	95575739	95576739	1000	chr10	95626965	95627065	AC131596.1	+	100	50226
chr10	95577167	95578349	1182	chr10	95626965	95627065	AC131596.1	+	100	48616
chr10	95578845	95581304	2459	chr10	95626965	95627065	AC131596.1	+	100	45661
chr10	95581582	95583968	2386	chr10	95626965	95627065	AC131596.1	+	100	42997
chr10	95594050	95595050	1000	chr10	95626965	95627065	AC131596.1	+	100	31915
chr10	95663380	95664508	1128	chr10	95626965	95627065	AC131596.1	+	100	36315
chr10	95676412	95677500	1088	chr10	95626965	95627065	AC131596.1	+	100	49347
chr10	95692917	95695153	2236	chr10	95626965	95627065	AC131596.1	+	100	65852
chr10	95699876	95703138	3262	chr10	95626965	95627065	AC131596.1	+	100	72811
chr10	95716756	95717840	1084	chr10	95626965	95627065	AC131596.1	+	100	89691
chr10	95725684	95727200	1516	chr10	95626965	95627065	AC131596.1	+	100	98619
chr10	95735994	95739122	3128	chr10	95626965	95627065	AC131596.1	+	100	108929
chr10	95794604	95796332	1728	chr10	95626965	95627065	AC131596.1	+	100	167539
chr10	95798523	95801661	3138	chr10	95626965	95627065	AC131596.1	+	100	171458
chr10	95802834	95806162	3328	chr10	95626965	95627065	AC131596.1	+	100	175769
chr10	95825777	95828513	2736	chr10	95626965	95627065	AC131596.1	+	100	198712
chr10	95832772	95834598	1826	chr10	95626965	95627065	AC131596.1	+	100	205707
chr10	95836140	95837297	1157	chr10	95626965	95627065	AC131596.1	+	100	209075
chr10	95838832	95841861	3029	chr10	95626965	95627065	AC131596.1	+	100	211767
chr10	95860517	95862230	1713	chr10	96079635	96085447	Btg1	+	5812	217405
chr10	95862274	95864471	2197	chr10	96079635	96085447	Btg1	+	5812	215164
chr10	95870032	95871705	1673	chr10	96079635	96085447	Btg1	+	5812	207930
chr10	95884022	95885454	1432	chr10	96079635	96085447	Btg1	+	5812	194181
chr10	95943295	95944295	1000	chr10	96079635	96085447	Btg1	+	5812	135340
chr10	96027971	96028971	1000	chr10	96079635	96085447	Btg1	+	5812	50664
chr10	96050390	96051543	1153	chr10	96079635	96085447	Btg1	+	5812	28092
chr10	96057885	96058978	1093	chr10	96079635	96085447	Btg1	+	5812	20657
chr10	96094716	96097118	2402	chr10	96079635	96085447	Btg1	+	5812	9269
chr10	96213568	96215139	1571	chr10	96318216	96318304	AC152946.1	-	88	103077
chr10	96774866	96776614	1748	chr10	96942245	96980777	Dcn	+	38532	165631
chr10	98070345	98072933	2588	chr10	98377786	98488777	Atp2b1	+	110991	304853
chr10	98073226	98076041	2815	chr10	98377786	98488777	Atp2b1	+	110991	301745
chr10	98146203	98147890	1687	chr10	98377786	98488777	Atp2b1	+	110991	229896
chr10	98206580	98208574	1994	chr10	98377786	98488777	Atp2b1	+	110991	169212
chr10	98237128	98241097	3969	chr10	98377786	98488777	Atp2b1	+	110991	136689
chr10	98242732	98245179	2447	chr10	98377786	98488777	Atp2b1	+	110991	132607
chr10	98260738	98262594	1856	chr10	98377786	98488777	Atp2b1	+	110991	115192
chr10	98303503	98304999	1496	chr10	98377786	98488777	Atp2b1	+	110991	72787
chr10	98339777	98344267	4490	chr10	98377786	98488777	Atp2b1	+	110991	33519
chr10	98543315	98545275	1960	chr10	98569670	98660708	Poc1b	+	91038	24395
chr10	98665965	98668126	2161	chr10	98569670	98660708	Poc1b	+	91038	5257
chr10	98704031	98706062	2031	chr10	98725865	98730122	Dusp6	+	4257	19803
chr10	98855531	98857195	1664	chr10	98883156	98885681	B530045E10Rik	+	2525	25961
chr10	98922275	98924621	2346	chr10	98906364	98909641	Gad1-ps	+	3277	12634
chr10	99054262	99055262	1000	chr10	98906364	98909641	Gad1-ps	+	3277	144621
chr10	99061630	99063352	1722	chr10	98906364	98909641	Gad1-ps	+	3277	151989
chr10	107368731	107370492	1761	chr10	107199369	107349190	Otogl	-	149821	19541
chr10	107529649	107530740	1091	chr10	107599249	107714631	Ppp1r12a	+	115382	68509
chr10	107592233	107593233	1000	chr10	107599249	107714631	Ppp1r12a	+	115382	6016
chr10	108551166	108553495	2329	chr10	108527054	108527331	7SK	-	277	23835
chr10	110257902	110260217	2315	chr10	110233229	110233356	SNORA17	+	127	24546
chr10	110467977	110469538	1561	chr10	110378838	110447122	Zdhhc17	-	68284	20855
chr10	110539071	110540826	1755	chr10	110562907	110563794	Gm5428	+	887	22081
chr10	110591877	110593633	1756	chr10	110601858	110734303	Osbpl8	+	132445	8225
chr10	110593680	110594812	1132	chr10	110601858	110734303	Osbpl8	+	132445	7046
chr10	110805354	110807321	1967	chr10	110735735	110738792	Bbs10	+	3057	66562
chr10	110815146	110816146	1000	chr10	110735735	110738792	Bbs10	+	3057	76354
chr10	110858784	110859784	1000	chr10	110910248	110935198	Nap1l1	+	24950	50464
chr10	110882780	110884287	1507	chr10	110910248	110935198	Nap1l1	+	24950	25961
chr10	110901267	110902396	1129	chr10	110910248	110935198	Nap1l1	+	24950	7852
chr10	110953160	110954872	1712	chr10	110943342	110945705	Phlda1	+	2363	7455
chr10	110975935	110977617	1682	chr10	110943342	110945705	Phlda1	+	2363	30230
chr10	111012505	111013505	1000	chr10	111023775	111031329	4933440J02Rik	-	7554	10270
chr10	114765171	114766289	1118	chr10	114777795	114799318	Tmem19	-	21523	11506
chr10	114769204	114770606	1402	chr10	114777795	114799318	Tmem19	-	21523	7189
chr10	116178168	116180605	2437	chr10	116213601	116333935	Gm239	-	120334	32996
chr10	116182907	116184099	1192	chr10	116213601	116333935	Gm239	-	120334	29502
chr10	116834727	116835727	1000	chr10	116781729	116817071	Cpsf6	-	35342	17656
chr10	116853701	116856235	2534	chr10	116781729	116817071	Cpsf6	-	35342	36630
chr10	116871830	116873706	1876	chr10	116781729	116817071	Cpsf6	-	35342	54759
chr10	116930009	116932146	2137	chr10	117031241	117031988	Kifc5c-ps	+	747	99095
chr10	117007775	117008775	1000	chr10	117031241	117031988	Kifc5c-ps	+	747	22466
chr10	117154121	117159643	5522	chr10	117125944	117147814	Mdm2	-	21870	6307
chr10	117297357	117298847	1490	chr10	117251527	117282991	Rap1b	-	31464	14366
chr10	117300875	117305515	4640	chr10	117251527	117282991	Rap1b	-	31464	17884
chr10	117334467	117337378	2911	chr10	117251527	117282991	Rap1b	-	31464	51476
chr10	117346254	117347849	1595	chr10	117251527	117282991	Rap1b	-	31464	63263
chr10	117379035	117381963	2928	chr10	117251527	117282991	Rap1b	-	31464	96044
chr10	117411572	117414070	2498	chr10	117251527	117282991	Rap1b	-	31464	128581
chr10	117419457	117420821	1364	chr10	117251527	117282991	Rap1b	-	31464	136466
chr10	117420874	117423167	2293	chr10	117251527	117282991	Rap1b	-	31464	137883
chr10	117423801	117425553	1752	chr10	117251527	117282991	Rap1b	-	31464	140810
chr10	117443680	117445128	1448	chr10	117578843	117606053	Mdm1	+	27210	133715
chr10	117448090	117450290	2200	chr10	117578843	117606053	Mdm1	+	27210	128553
chr10	117487195	117488195	1000	chr10	117578843	117606053	Mdm1	+	27210	90648
chr10	117519971	117521345	1374	chr10	117578843	117606053	Mdm1	+	27210	57498
chr10	117521715	117523262	1547	chr10	117578843	117606053	Mdm1	+	27210	55581
chr10	117527197	117528401	1204	chr10	117578843	117606053	Mdm1	+	27210	50442
chr10	117536985	117538020	1035	chr10	117578843	117606053	Mdm1	+	27210	40823
chr10	117614667	117616948	2281	chr10	117578843	117606053	Mdm1	+	27210	8614
chr10	117855548	117856874	1326	chr10	117878103	117882948	Ifng	+	4845	21229
chr10	117907067	117908067	1000	chr10	117878103	117882948	Ifng	+	4845	24119
chr10	117917770	117918770	1000	chr10	117878103	117882948	Ifng	+	4845	34822
chr10	117931608	117933506	1898	chr10	117878103	117882948	Ifng	+	4845	48660
chr10	117942301	117943465	1164	chr10	117878103	117882948	Ifng	+	4845	59353
chr10	118145946	118147674	1728	chr10	118296405	118305959	Dyrk2	-	9554	148731
chr10	118233219	118234219	1000	chr10	118296405	118305959	Dyrk2	-	9554	62186
chr10	118241162	118242816	1654	chr10	118296405	118305959	Dyrk2	-	9554	53589
chr10	118247160	118248907	1747	chr10	118296405	118305959	Dyrk2	-	9554	47498
chr10	118319454	118321496	2042	chr10	118296405	118305959	Dyrk2	-	9554	13495
chr10	118463800	118466906	3106	chr10	118296405	118305959	Dyrk2	-	9554	157841
chr10	120053261	120054737	1476	chr10	120042593	120042652	SNORA17	+	59	10609
chr10	120181763	120183403	1640	chr10	120202830	120215942	4921513I03Rik	+	13112	19427
chr10	120925010	120926752	1742	chr10	120847406	120913306	Rassf3	-	65900	11704
chr10	120937461	120939084	1623	chr10	120847406	120913306	Rassf3	-	65900	24155
chr10	120941958	120942990	1032	chr10	120847406	120913306	Rassf3	-	65900	28652
chr10	120943700	120945534	1834	chr10	120847406	120913306	Rassf3	-	65900	30394
chr10	121491121	121492121	1000	chr10	121218047	121484371	Srgap1	-	266324	6750
chr10	124806772	124808110	1338	chr10	124663520	124766019	Slc16a7	-	102499	40753
chr10	124824763	124825763	1000	chr10	124663520	124766019	Slc16a7	-	102499	58744
chr10	125185293	125186293	1000	chr10	125403275	125452415	Lrig3	+	49140	216982
chr10	125871413	125872475	1062	chr10	125473883	125473955	AC153489.1	+	72	397458
chr10	125873700	125875712	2012	chr10	125473883	125473955	AC153489.1	+	72	399745
chr10	125935314	125936623	1309	chr10	126277431	126277557	SNORA17	-	126	340808
chr10	125937852	125940239	2387	chr10	126277431	126277557	SNORA17	-	126	337192
chr10	126037409	126039293	1884	chr10	126277431	126277557	SNORA17	-	126	238138
chr10	128039015	128042372	3357	chr10	128052412	128053677	Gm9182	+	1265	10040
chr10	129748036	129749607	1571	chr10	129759908	129801091	Tespa1	+	41183	10301
chr10	129807129	129809302	2173	chr10	129759908	129801091	Tespa1	+	41183	6038
chr10	129978985	129980065	1080	chr10	129908388	129934435	Vmn2r87	-	26047	44550
chr10	10949482	10950482	1000	chr10	10869225	10937393	Shprh	+	68168	12089
chr10	13664744	13665744	1000	chr10	13686185	13871182	Hivep2	+	184997	20441
chr10	13906354	13907354	1000	chr10	13686185	13871182	Hivep2	+	184997	35172
chr10	16951932	16952932	1000	chr10	16836610	16836706	U6	+	96	115226
chr10	17204680	17205703	1023	chr10	17443034	17445479	Cited2	+	2445	237331
chr10	17403543	17404855	1312	chr10	17443034	17445479	Cited2	+	2445	38179
chr10	18782228	18784194	1966	chr10	18720716	18735463	Tnfaip3	-	14747	46765
chr10	19010799	19011799	1000	chr10	19076366	19078412	Olig3	+	2046	64567
chr10	20812714	20813714	1000	chr10	20672391	20800234	Ahi1	+	127843	12480
chr10	22026174	22027236	1062	chr10	21878392	22008655	H60b	+	130263	17519
chr10	23560464	23561464	1000	chr10	23571268	23589649	Vnn3	+	18381	9804
chr10	24473427	24475022	1595	chr10	24493620	24556001	Enpp3	-	62381	18598
chr10	36968516	36970647	2131	chr10	37057292	37099458	Gm16988	+	42166	86645
chr10	37531628	37532708	1080	chr10	37651486	37651586	AC155948.1	+	100	118778
chr10	37773101	37774173	1072	chr10	37651486	37651586	AC155948.1	+	100	121515
chr10	40209053	40210053	1000	chr10	40069114	40203624	Cdk19	+	134510	5429
chr10	43387078	43388078	1000	chr10	43313233	43350722	F930017D23Rik	+	37489	36356
chr10	44327024	44328123	1099	chr10	44317046	44317133	U6	-	87	9891
chr10	51173575	51174660	1085	chr10	51200438	51206122	Gp49a	+	5684	25778
chr10	52887675	52888675	1000	chr10	52940181	52940262	AC105169.1	-	81	51506
chr10	53583174	53584174	1000	chr10	53624594	53795602	Man1a	-	171008	40420
chr10	59370424	59371489	1065	chr10	59342304	59362050	Dnajb12	+	19746	8374
chr10	59624282	59625296	1014	chr10	59644280	59682008	Chst3	-	37728	18984
chr10	59631060	59632761	1701	chr10	59644280	59682008	Chst3	-	37728	11519
chr10	66327010	66328288	1278	chr10	66375237	66383006	1110002J07Rik	-	7769	46949
chr10	66416425	66417621	1196	chr10	66383650	66386347	Gm17351	+	2697	30078
chr10	66466226	66467806	1580	chr10	66474256	66559605	Reep3	-	85349	6450
chr10	66966193	66967328	1135	chr10	66998223	67004936	Egr2	+	6713	30895
chr10	67109471	67111024	1553	chr10	67034790	67037011	Gm10797	+	2221	72460
chr10	67143969	67148895	4926	chr10	67034790	67037011	Gm10797	+	2221	106958
chr10	67163709	67164709	1000	chr10	67034790	67037011	Gm10797	+	2221	126698
chr10	68306713	68307797	1084	chr10	68186494	68245402	Tmem26	+	58908	61311
chr10	78879769	78880832	1063	chr10	78819321	78859943	Vmn2r82	+	40622	19826
chr10	81459869	81460875	1006	chr10	81471136	81471603	Gm8290	+	467	10261
chr10	83574438	83575438	1000	chr10	83833650	83903342	Nuak1	-	69692	258212
chr10	83942946	83944476	1530	chr10	83951038	83960180	4930463O16Rik	+	9142	6562
chr10	85291851	85293041	1190	chr10	85270560	85271990	Gm6721	+	1430	19861
chr10	88094172	88095172	1000	chr10	87981024	88067897	Mybpc1	-	86873	26275
chr10	90644611	90645655	1044	chr10	90610316	90634759	Tmpo	-	24443	9852
chr10	90733208	90734208	1000	chr10	90690931	90691257	Gm16484	+	326	41951
chr10	92816762	92817762	1000	chr10	92710159	92773880	Elk3	-	63721	42882
chr10	92822285	92824338	2053	chr10	92710159	92773880	Elk3	-	63721	48405
chr10	92861287	92862287	1000	chr10	92916141	92947641	Lta4h	+	31500	53854
chr10	94429754	94430754	1000	chr10	94411224	94411527	7SK	+	303	18227
chr10	94812384	94813496	1112	chr10	94637380	94786767	Cradd	-	149387	25617
chr10	95224750	95225750	1000	chr10	95255205	95257614	4732465J04Rik	+	2409	29455
chr10	95724152	95725244	1092	chr10	95626965	95627065	AC131596.1	+	100	97087
chr10	95729002	95730029	1027	chr10	95626965	95627065	AC131596.1	+	100	101937
chr10	95892808	95893808	1000	chr10	96079635	96085447	Btg1	+	5812	185827
chr10	96068531	96069682	1151	chr10	96079635	96085447	Btg1	+	5812	9953
chr10	110554355	110556095	1740	chr10	110562907	110563794	Gm5428	+	887	6812
chr10	110556149	110557276	1127	chr10	110562907	110563794	Gm5428	+	887	5631
chr10	116829856	116831364	1508	chr10	116781729	116817071	Cpsf6	-	35342	12785
chr10	116892600	116893600	1000	chr10	116781729	116817071	Cpsf6	-	35342	75529
chr10	116969053	116970233	1180	chr10	117031241	117031988	Kifc5c-ps	+	747	61008
chr10	117329775	117330775	1000	chr10	117251527	117282991	Rap1b	-	31464	46784
chr10	117377527	117378892	1365	chr10	117251527	117282991	Rap1b	-	31464	94536
chr10	117389203	117390876	1673	chr10	117251527	117282991	Rap1b	-	31464	106212
chr10	117538128	117539326	1198	chr10	117578843	117606053	Mdm1	+	27210	39517
chr10	118036549	118037667	1118	chr10	117878103	117882948	Ifng	+	4845	153601
chr10	124825958	124827016	1058	chr10	124663520	124766019	Slc16a7	-	102499	59939
chr10	129750861	129751861	1000	chr10	129759908	129801091	Tespa1	+	41183	8047
chr11	3004098	3006468	2370	chr11	3025907	3031007	Pisd-ps1	+	5100	19439
chr11	5076224	5078052	1828	chr11	5091555	5161561	Kremen1	-	70006	13503
chr11	5384737	5387808	3071	chr11	5395195	5395449	Gm11962	-	254	7387
chr11	5411361	5414063	2702	chr11	5398843	5405702	Gm11963	+	6859	5659
chr11	6265127	6267038	1911	chr11	6191636	6256645	Ogdh	+	65009	8482
chr11	8588746	8590030	1284	chr11	8331655	8564538	Tns3	-	232883	24208
chr11	11428212	11429720	1508	chr11	11362097	11415195	4930415F15Rik	+	53098	13017
chr11	16457909	16460241	2332	chr11	16414536	16415984	Akt2-ps	+	1448	41925
chr11	16490826	16491826	1000	chr11	16534866	16536110	Gm12663	-	1244	43040
chr11	16640629	16641864	1235	chr11	16632608	16632714	U6	-	106	7915
chr11	20363859	20366805	2946	chr11	20346415	20346813	Gm12034	+	398	17046
chr11	20368047	20370041	1994	chr11	20346415	20346813	Gm12034	+	398	21234
chr11	20377001	20378492	1491	chr11	20346415	20346813	Gm12034	+	398	30188
chr11	20430644	20432689	2045	chr11	20443256	20553024	Sertad2	+	109768	10567
chr11	20813408	20815182	1774	chr11	20747756	20747884	SNORA65	-	128	65524
chr11	20932738	20934770	2032	chr11	20991294	21050326	Peli1	+	59032	56524
chr11	20944771	20948089	3318	chr11	20991294	21050326	Peli1	+	59032	43205
chr11	21073861	21075449	1588	chr11	21097711	21097979	7SK	-	268	22262
chr11	21449027	21450663	1636	chr11	21456790	21472370	Mdh1	-	15580	6127
chr11	22551983	22554025	2042	chr11	22526378	22526667	Gm12053	-	289	25316
chr11	22565165	22567350	2185	chr11	22526378	22526667	Gm12053	-	289	38498
chr11	22592203	22593268	1065	chr11	22608883	22609260	Gm12054	-	377	15615
chr11	23705122	23706812	1690	chr11	23676903	23677047	U1	-	144	28075
chr11	23710473	23711473	1000	chr11	23676903	23677047	U1	-	144	33426
chr11	23722336	23723571	1235	chr11	23762646	23795253	Papolg	-	32607	39075
chr11	23745428	23747071	1643	chr11	23762646	23795253	Papolg	-	32607	15575
chr11	23754595	23755595	1000	chr11	23762646	23795253	Papolg	-	32607	7051
chr11	23813052	23814894	1842	chr11	23828596	23828854	Gm12062	-	258	13702
chr11	23853822	23854918	1096	chr11	23828596	23828854	Gm12062	-	258	24968
chr11	23887147	23888876	1729	chr11	23828596	23828854	Gm12062	-	258	58293
chr11	24084573	24086249	1676	chr11	23978056	24074123	Bcl11a	+	96067	10450
chr11	24135331	24136331	1000	chr11	24101418	24117601	Gm12066	+	16183	17730
chr11	24153859	24157614	3755	chr11	24101418	24117601	Gm12066	+	16183	36258
chr11	24159412	24160412	1000	chr11	24101418	24117601	Gm12066	+	16183	41811
chr11	24175619	24177242	1623	chr11	24101418	24117601	Gm12066	+	16183	58018
chr11	24196996	24197996	1000	chr11	24101418	24117601	Gm12066	+	16183	79395
chr11	24290177	24291309	1132	chr11	24326246	24622646	Gm12068	+	296400	34937
chr11	26503571	26505271	1700	chr11	26371322	26493999	Vrk2	-	122677	9572
chr11	26539662	26541509	1847	chr11	26371322	26493999	Vrk2	-	122677	45663
chr11	27001138	27004053	2915	chr11	26987017	26987135	SNORA17	-	118	14003
chr11	31632220	31633330	1110	chr11	31690113	31724524	D630024D03Rik	-	34411	56783
chr11	31848831	31849831	1000	chr11	31772211	31835634	Cpeb4	+	63423	13197
chr11	32230359	32231870	1511	chr11	32247820	32328173	Sh3pxd2b	+	80353	15950
chr11	34011258	34012374	1116	chr11	33873961	33998554	4930469K13Rik	-	124593	12704
chr11	34609126	34610126	1000	chr11	34126815	34597394	Dock2	-	470579	11732
chr11	34701576	34702576	1000	chr11	34693841	34696033	Gm12711	+	2192	5543
chr11	34895260	34897591	2331	chr11	34934726	35522009	Slit3	+	587283	37135
chr11	34903219	34905506	2287	chr11	34934726	35522009	Slit3	+	587283	29220
chr11	42781252	42782352	1100	chr11	42849248	42850780	Gm9972	+	1532	66896
chr11	42906862	42910429	3567	chr11	42919642	42929796	Gm12145	-	10154	9213
chr11	42956941	42957941	1000	chr11	42963379	43075787	Atp10b	+	112408	5438
chr11	43156148	43159040	2892	chr11	43187899	43187963	Mir146	-	64	28859
chr11	43166560	43168302	1742	chr11	43187899	43187963	Mir146	-	64	19597
chr11	43171131	43173612	2481	chr11	43187899	43187963	Mir146	-	64	14287
chr11	43206069	43209925	3856	chr11	43198984	43200685	Gm12148	+	1701	5384
chr11	43223194	43225233	2039	chr11	43233752	43239753	Pttg1	-	6001	8519
chr11	44309209	44310559	1350	chr11	44292709	44293711	Gm12156	+	1002	15498
chr11	44310643	44312972	2329	chr11	44292709	44293711	Gm12156	+	1002	16932
chr11	44317121	44318758	1637	chr11	44332466	44379022	Rnf145	+	46556	13708
chr11	44388044	44389344	1300	chr11	44332466	44379022	Rnf145	+	46556	9022
chr11	44390756	44391756	1000	chr11	44399819	44404731	4930597A21Rik	+	4912	8063
chr11	44902956	44903956	1000	chr11	44916368	44930430	Gm12159	-	14062	12412
chr11	45358707	45360993	2286	chr11	45222544	45282006	Gm12162	-	59462	76701
chr11	45565708	45567506	1798	chr11	45621589	45654673	F630206G17Rik	+	33084	54083
chr11	48600697	48602520	1823	chr11	48613834	48619936	Gnb2l1	+	6102	11314
chr11	49810288	49811330	1042	chr11	49715337	49794496	Rasgef1c	+	79159	15792
chr11	51614075	51615194	1119	chr11	51577189	51605427	Sar1b	+	28238	8648
chr11	51618532	51619732	1200	chr11	51626957	51671155	Phf15	-	44198	7225
chr11	51687793	51689184	1391	chr11	51626957	51671155	Phf15	-	44198	16638
chr11	51729106	51730423	1317	chr11	51763384	52083016	Gm16953	-	319632	32961
chr11	51744896	51745896	1000	chr11	51763384	52083016	Gm16953	-	319632	17488
chr11	51748894	51752878	3984	chr11	51763384	52083016	Gm16953	-	319632	10506
chr11	52131762	52132762	1000	chr11	52089557	52099681	A630014C17Rik	+	10124	32081
chr11	52137061	52139569	2508	chr11	52174362	52202899	Vdac1	+	28537	34793
chr11	52154496	52155496	1000	chr11	52174362	52202899	Vdac1	+	28537	18866
chr11	52159686	52160872	1186	chr11	52174362	52202899	Vdac1	+	28537	13490
chr11	53120847	53122627	1780	chr11	53073316	53113959	Hspa4	-	40643	6888
chr11	53576774	53577824	1050	chr11	53583516	53591876	Irf1	+	8360	5692
chr11	53901127	53902926	1799	chr11	53913597	53945167	P4ha2	+	31570	10671
chr11	53904093	53907016	2923	chr11	53913597	53945167	P4ha2	+	31570	6581
chr11	53962701	53964586	1885	chr11	53972428	53973558	Gm12221	+	1130	7842
chr11	54106873	54109010	2137	chr11	54117300	54178258	Acsl6	+	60958	8290
chr11	54615151	54616908	1757	chr11	54530958	54601177	Cdc42se2	-	70219	13974
chr11	54620550	54622787	2237	chr11	54633421	54638469	Gm12228	+	5048	10634
chr11	54786054	54787241	1187	chr11	54792610	54846947	Anxa6	-	54337	5369
chr11	57770248	57772744	2496	chr11	57762231	57762587	Gm12245	-	356	7661
chr11	57775661	57776757	1096	chr11	57782844	57783114	7SK	+	270	6087
chr11	59449976	59451038	1062	chr11	59426468	59427727	Olfr225	+	1259	22249
chr11	59745924	59746924	1000	chr11	59735001	59735391	1810063I02Rik	+	390	10533
chr11	60916233	60918803	2570	chr11	60940257	60962874	Tnfrsf13b	+	22617	21454
chr11	61443065	61444065	1000	chr11	61466767	61486286	Grap	+	19519	22702
chr11	61452157	61453188	1031	chr11	61466767	61486286	Grap	+	19519	13579
chr11	62488711	62489831	1120	chr11	62462166	62479856	Mmgt2	+	17690	8855
chr11	65607529	65609599	2070	chr11	65501745	65601799	Map2k4	-	100054	5730
chr11	66686034	66688197	2163	chr11	66719223	66760588	Gm12298	-	41365	31026
chr11	66957456	66958886	1430	chr11	66925963	66933582	2310065F04Rik	-	7619	23874
chr11	67203565	67205059	1494	chr11	67135160	67185088	Myh13	+	49928	18477
chr11	69071378	69074912	3534	chr11	69054101	69054205	U6	+	104	17173
chr11	69079816	69082864	3048	chr11	69107653	69108979	1700067G03Rik	+	1326	24789
chr11	69897662	69898662	1000	chr11	69906146	69919689	Asgr2	+	13543	7484
chr11	70119016	70120591	1575	chr11	70129112	70136130	Alox12e	-	7018	8521
chr11	72371421	72373007	1586	chr11	72308421	72364008	Spns3	-	55587	7413
chr11	72407699	72409892	2193	chr11	72420785	72499983	Ube2g1	+	79198	10893
chr11	72410163	72411335	1172	chr11	72420785	72499983	Ube2g1	+	79198	9450
chr11	72753734	72754874	1140	chr11	72609728	72740622	Zzef1	+	130894	13112
chr11	72759377	72761214	1837	chr11	72774671	72806546	Atp2a3	+	31875	13457
chr11	72766741	72768521	1780	chr11	72774671	72806546	Atp2a3	+	31875	6150
chr11	75092531	75093866	1335	chr11	75007285	75081271	Rtn4rl1	+	73986	11260
chr11	75779855	75780903	1048	chr11	75644501	75751931	Rph3al	-	107430	27924
chr11	75789460	75793394	3934	chr11	75813414	75817071	1700016K19Rik	+	3657	20020
chr11	75796289	75799194	2905	chr11	75813414	75817071	1700016K19Rik	+	3657	14220
chr11	76687279	76688279	1000	chr11	76591926	76660520	Cpd	-	68594	26759
chr11	77009985	77010985	1000	chr11	76903417	77002470	Efcab5	-	99053	7515
chr11	78605359	78606917	1558	chr11	78637889	78637975	U6	+	86	30972
chr11	78699674	78701448	1774	chr11	78734289	78773756	Nos2	+	39467	32841
chr11	78810794	78812923	2129	chr11	78776476	78798448	Lgals9	-	21972	12346
chr11	78815747	78816877	1130	chr11	78826942	78959909	Ksr1	-	132967	10065
chr11	78819071	78820804	1733	chr11	78826942	78959909	Ksr1	-	132967	6138
chr11	79037867	79038867	1000	chr11	79026298	79026745	Gm11200	+	447	11122
chr11	79091614	79093270	1656	chr11	79109681	79110408	Gm9964	-	727	16411
chr11	79099539	79101620	2081	chr11	79109681	79110408	Gm9964	-	727	8061
chr11	79119056	79121416	2360	chr11	79109681	79110408	Gm9964	-	727	8648
chr11	79552085	79553726	1641	chr11	79539902	79540013	Mir365-2	+	111	12072
chr11	82890833	82893793	2960	chr11	82878614	82884180	Slfn2	+	5566	6653
chr11	83052358	83054207	1849	chr11	83037078	83040106	AI662270	+	3028	12252
chr11	83375773	83377700	1927	chr11	83386421	83392138	Ccl9	-	5717	8721
chr11	83550122	83551907	1785	chr11	83560442	83566144	1100001G20Rik	+	5702	8535
chr11	86193348	86196214	2866	chr11	86080535	86171104	Med13	-	90569	22244
chr11	86196888	86198770	1882	chr11	86222328	86222447	5S_rRNA	+	119	23558
chr11	86208761	86210882	2121	chr11	86222328	86222447	5S_rRNA	+	119	11446
chr11	86211885	86214201	2316	chr11	86222328	86222447	5S_rRNA	+	119	8127
chr11	86240363	86243436	3073	chr11	86250812	86250917	U6	-	105	7376
chr11	86286093	86287124	1031	chr11	86298159	86312527	Rnft1	+	14368	11035
chr11	86386135	86389177	3042	chr11	86358493	86380862	Tubd1	+	22369	5273
chr11	86626801	86627807	1006	chr11	86582348	86621198	Dhx40	-	38850	5603
chr11	86647086	86648289	1203	chr11	86637694	86637961	AL596111.1	+	267	9125
chr11	86648694	86650287	1593	chr11	86637694	86637961	AL596111.1	+	267	10733
chr11	86652711	86653711	1000	chr11	86637694	86637961	AL596111.1	+	267	14750
chr11	86664439	86665439	1000	chr11	86637694	86637961	AL596111.1	+	267	26478
chr11	86705900	86708212	2312	chr11	86749927	86807209	Ypel2	-	57282	41715
chr11	86723710	86724710	1000	chr11	86749927	86807209	Ypel2	-	57282	25217
chr11	88046855	88048484	1629	chr11	88017890	88025009	Mrps23	+	7119	21846
chr11	88888834	88890104	1270	chr11	88896493	88928164	Dgke	-	31671	6389
chr11	93848257	93849440	1183	chr11	93857405	93987399	Spag9	+	129994	7965
chr11	94120608	94122009	1401	chr11	94097270	94107319	Wfikkn2	-	10049	13289
chr11	94134540	94136220	1680	chr11	94149204	94183302	Luc7l3	-	34098	12984
chr11	95549422	95550672	1250	chr11	95528271	95542087	Phb	+	13816	7335
chr11	96853842	96855003	1161	chr11	96814654	96844273	Sp2	-	29619	9569
chr11	96856271	96857639	1368	chr11	96814654	96844273	Sp2	-	29619	11998
chr11	96987171	96990654	3483	chr11	96997485	97012809	Tbkbp1	-	15324	6831
chr11	97169707	97171781	2074	chr11	97177030	97191234	Mrpl45	+	14204	5249
chr11	97267537	97268537	1000	chr11	97223865	97259856	Socs7	+	35991	7681
chr11	98643853	98645151	1298	chr11	98629246	98636647	Nr1d1	-	7401	7206
chr11	98647046	98648473	1427	chr11	98656830	98669173	Msl1	+	12343	8357
chr11	98649552	98651431	1879	chr11	98656830	98669173	Msl1	+	12343	5399
chr11	98992817	98996014	3197	chr11	99005510	99016391	Ccr7	-	10881	9496
chr11	98997575	98998575	1000	chr11	99005510	99016391	Ccr7	-	10881	6935
chr11	99021877	99025076	3199	chr11	99005510	99016391	Ccr7	-	10881	5486
chr11	99028526	99029734	1208	chr11	99005510	99016391	Ccr7	-	10881	12135
chr11	99031667	99033337	1670	chr11	99005510	99016391	Ccr7	-	10881	15276
chr11	99037319	99040598	3279	chr11	99005510	99016391	Ccr7	-	10881	20928
chr11	99049757	99051551	1794	chr11	99070361	99092331	Smarce1	-	21970	18810
chr11	99111211	99112211	1000	chr11	99094075	99105399	Krt222	-	11324	5812
chr11	101004790	101005915	1125	chr11	101017221	101023101	Tubg2	+	5880	11306
chr11	101785770	101787095	1325	chr11	101800815	101801213	Rpl27-ps2	+	398	13720
chr11	103304062	103305282	1220	chr11	103313269	103365911	Lrrc37a	-	52642	7987
chr11	103861573	103863655	2082	chr11	103828053	103846651	Arf2	+	18598	14922
chr11	103874245	103875811	1566	chr11	103828053	103846651	Arf2	+	18598	27594
chr11	106822683	106824207	1524	chr11	106833372	106834404	Gm11707	-	1032	9165
chr11	106873256	106874330	1074	chr11	106865223	106866054	Gm11708	-	831	7202
chr11	109173262	109174313	1051	chr11	109086669	109159443	Rgs9	-	72774	13819
chr11	109192054	109193607	1553	chr11	109216092	109224968	Gm11696	-	8876	22485
chr11	109720887	109722476	1589	chr11	109707192	109709790	1700023C21Rik	+	2598	11097
chr11	109736745	109738043	1298	chr11	109707192	109709790	1700023C21Rik	+	2598	26955
chr11	110230355	110231959	1604	chr11	110260436	110386836	Map2k6	+	126400	28477
chr11	110232944	110234911	1967	chr11	110260436	110386836	Map2k6	+	126400	25525
chr11	110822603	110824204	1601	chr11	110829347	110889282	Kcnj16	+	59935	5143
chr11	111678711	111680759	2048	chr11	111657661	111662190	Gm11674	-	4529	16521
chr11	112016167	112017167	1000	chr11	111968752	111993510	Gm11680	+	24758	22657
chr11	114744030	114745408	1378	chr11	114751355	114765968	Cd300a	+	14613	5947
chr11	115495083	115496083	1000	chr11	115475492	115489595	Slc25a19	-	14103	5488
chr11	115577483	115580252	2769	chr11	115585608	115586148	Gm11703	-	540	5356
chr11	115608140	115609140	1000	chr11	115590780	115590993	Gm11704	+	213	17147
chr11	116180161	116181711	1550	chr11	116187916	116188031	n-R5s74	-	115	6205
chr11	116284516	116285583	1067	chr11	116295408	116300391	Fam100b	+	4983	9825
chr11	116746463	116747516	1053	chr11	116713754	116736949	Mfsd11	+	23195	9514
chr11	117035806	117036931	1125	chr11	116976482	117020582	Sec14l1	+	44100	15224
chr11	117330884	117333150	2266	chr11	117345682	117350328	Gm11733	+	4646	12532
chr11	117337293	117338293	1000	chr11	117345682	117350328	Gm11733	+	4646	7389
chr11	117459927	117460984	1057	chr11	117472561	117475171	2900041M22Rik	+	2610	11577
chr11	117806580	117808815	2235	chr11	117827393	117831361	Socs3	-	3968	18578
chr11	117810472	117811550	1078	chr11	117827393	117831361	Socs3	-	3968	15843
chr11	117812578	117814478	1900	chr11	117827393	117831361	Socs3	-	3968	12915
chr11	117820684	117822102	1418	chr11	117827393	117831361	Socs3	-	3968	5291
chr11	117836658	117837840	1182	chr11	117827393	117831361	Socs3	-	3968	5297
chr11	118223945	118225005	1060	chr11	118162383	118217054	Timp2	-	54671	6891
chr11	118240449	118241489	1040	chr11	118254065	118263406	Lgals3bp	-	9341	12576
chr11	118841535	118843271	1736	chr11	118849417	118854243	Enpp7	+	4826	6146
chr11	118907983	118909860	1877	chr11	118897619	118902283	Cbx8	-	4664	5700
chr11	119785924	119786924	1000	chr11	119774755	119780862	Chmp6	+	6107	5062
chr11	119789441	119790507	1066	chr11	119797117	119804012	Gm11767	-	6895	6610
chr11	120176828	120178504	1676	chr11	120094261	120153610	Bahcc1	+	59349	23218
chr11	120371467	120372914	1447	chr11	120353154	120360501	Slc25a10	+	7347	10966
chr11	8591307	8592307	1000	chr11	8331655	8564538	Tns3	-	232883	26769
chr11	8601072	8602072	1000	chr11	8331655	8564538	Tns3	-	232883	36534
chr11	11421716	11422955	1239	chr11	11362097	11415195	4930415F15Rik	+	53098	6521
chr11	11446952	11448319	1367	chr11	11457424	11479463	Gm11998	+	22039	9105
chr11	20032782	20033942	1160	chr11	20042571	20042793	Gm12030	+	222	8629
chr11	20355164	20356164	1000	chr11	20346415	20346813	Gm12034	+	398	8351
chr11	20432795	20433795	1000	chr11	20443256	20553024	Sertad2	+	109768	9461
chr11	21078715	21079773	1058	chr11	21097711	21097979	7SK	-	268	17938
chr11	21079921	21082537	2616	chr11	21097711	21097979	7SK	-	268	15174
chr11	22484556	22485556	1000	chr11	22500338	22510882	Gm17335	-	10544	14782
chr11	22491487	22492487	1000	chr11	22500338	22510882	Gm17335	-	10544	7851
chr11	22593335	22596242	2907	chr11	22608883	22609260	Gm12054	-	377	12641
chr11	23755689	23757181	1492	chr11	23762646	23795253	Papolg	-	32607	5465
chr11	24143000	24144412	1412	chr11	24101418	24117601	Gm12066	+	16183	25399
chr11	24146007	24147007	1000	chr11	24101418	24117601	Gm12066	+	16183	28406
chr11	24157649	24159224	1575	chr11	24101418	24117601	Gm12066	+	16183	40048
chr11	24300706	24301706	1000	chr11	24326246	24622646	Gm12068	+	296400	24540
chr11	43580602	43581702	1100	chr11	43588108	43714712	Adra1b	-	126604	6406
chr11	54037545	54038545	1000	chr11	53991274	54026787	4933405E24Rik	-	35513	10758
chr11	60922355	60923359	1004	chr11	60940257	60962874	Tnfrsf13b	+	22617	16898
chr11	60929633	60930633	1000	chr11	60940257	60962874	Tnfrsf13b	+	22617	9624
chr11	61221183	61222299	1116	chr11	61229904	61230317	Gm12271	-	413	7605
chr11	61416335	61417335	1000	chr11	61330751	61393187	Epn2	-	62436	23148
chr11	61433281	61434723	1442	chr11	61466767	61486286	Grap	+	19519	32044
chr11	61453376	61454376	1000	chr11	61466767	61486286	Grap	+	19519	12391
chr11	61458123	61459896	1773	chr11	61466767	61486286	Grap	+	19519	6871
chr11	66796690	66799390	2700	chr11	66815588	66825127	Gm12299	+	9539	16198
chr11	77443224	77444414	1190	chr11	77453356	77453535	Gm12732	+	179	8942
chr11	79124175	79125175	1000	chr11	79109681	79110408	Gm9964	-	727	13767
chr11	83363756	83365612	1856	chr11	83339280	83344020	Ccl5	-	4740	19736
chr11	85802813	85803928	1115	chr11	85796070	85796148	AL592465.2	+	78	6665
chr11	86198985	86200277	1292	chr11	86222328	86222447	5S_rRNA	+	119	22051
chr11	86243776	86245318	1542	chr11	86250812	86250917	U6	-	105	5494
chr11	86721175	86722219	1044	chr11	86749927	86807209	Ypel2	-	57282	27708
chr11	87781717	87782717	1000	chr11	87793027	87801035	Dynll2	-	8008	10310
chr11	88048707	88049707	1000	chr11	88017890	88025009	Mrps23	+	7119	23698
chr11	88890114	88891114	1000	chr11	88896493	88928164	Dgke	-	31671	5379
chr11	88961935	88962935	1000	chr11	88935155	88954354	Gm525	+	19199	7581
chr11	94482290	94484533	2243	chr11	94491081	94506530	Lrrc59	+	15449	6548
chr11	96857896	96859124	1228	chr11	96814654	96844273	Sp2	-	29619	13623
chr11	99048212	99049355	1143	chr11	99070361	99092331	Smarce1	-	21970	21006
chr11	104864392	104865392	1000	chr11	104892471	104893161	Gm11622	+	690	27079
chr11	106843115	106844760	1645	chr11	106849943	106860855	Kpna2	-	10912	5183
chr11	110240953	110241953	1000	chr11	110260436	110386836	Map2k6	+	126400	18483
chr11	116644071	116645071	1000	chr11	116600308	116636821	St6galnac1	-	36513	7250
chr11	118952989	118953989	1000	chr11	118959278	118959348	AL662835.1	+	70	5289
chr11	120166403	120167403	1000	chr11	120094261	120153610	Bahcc1	+	59349	12793
chr12	3547745	3548818	1073	chr12	3572381	3781796	Dtnb	+	209415	23563
chr12	3790903	3792887	1984	chr12	3572381	3781796	Dtnb	+	209415	9107
chr12	4554895	4555918	1023	chr12	4599632	4599733	Gm3625	-	101	43714
chr12	8357881	8360816	2935	chr12	8320239	8350630	Hs1bp3	+	30391	7251
chr12	8365665	8367216	1551	chr12	8320239	8350630	Hs1bp3	+	30391	15035
chr12	8391862	8394404	2542	chr12	8320239	8350630	Hs1bp3	+	30391	41232
chr12	8527652	8529389	1737	chr12	8535289	8605872	Slc7a15	-	70583	5900
chr12	8644805	8645942	1137	chr12	8680940	8759387	Pum2	+	78447	34998
chr12	8647241	8648264	1023	chr12	8680940	8759387	Pum2	+	78447	32676
chr12	8663981	8664981	1000	chr12	8680940	8759387	Pum2	+	78447	15959
chr12	8665233	8667402	2169	chr12	8680940	8759387	Pum2	+	78447	13538
chr12	8835582	8837952	2370	chr12	8778129	8800521	Sdc1	+	22392	35061
chr12	8853155	8854353	1198	chr12	8879993	8884265	9930038B18Rik	-	4272	25640
chr12	12552286	12553286	1000	chr12	12706845	12706951	U6	+	106	153559
chr12	12553337	12555519	2182	chr12	12706845	12706951	U6	+	106	151326
chr12	12585737	12588721	2984	chr12	12706845	12706951	U6	+	106	118124
chr12	15592900	15594852	1952	chr12	15798533	15823683	Trib2	-	25150	203681
chr12	15600477	15602729	2252	chr12	15798533	15823683	Trib2	-	25150	195804
chr12	15708387	15710341	1954	chr12	15798533	15823683	Trib2	-	25150	88192
chr12	15718836	15722348	3512	chr12	15798533	15823683	Trib2	-	25150	76185
chr12	15722435	15725404	2969	chr12	15798533	15823683	Trib2	-	25150	73129
chr12	15725971	15728056	2085	chr12	15798533	15823683	Trib2	-	25150	70477
chr12	15761078	15762616	1538	chr12	15798533	15823683	Trib2	-	25150	35917
chr12	15903283	15904283	1000	chr12	15823809	15894961	Gm5432	+	71152	8322
chr12	15918038	15920788	2750	chr12	15823809	15894961	Gm5432	+	71152	23077
chr12	15937301	15941697	4396	chr12	15823809	15894961	Gm5432	+	71152	42340
chr12	15976867	15979438	2571	chr12	15823809	15894961	Gm5432	+	71152	81906
chr12	15987670	15989429	1759	chr12	15823809	15894961	Gm5432	+	71152	92709
chr12	16004049	16006933	2884	chr12	15823809	15894961	Gm5432	+	71152	109088
chr12	16012929	16013929	1000	chr12	15823809	15894961	Gm5432	+	71152	117968
chr12	16014146	16017143	2997	chr12	15823809	15894961	Gm5432	+	71152	119185
chr12	16139094	16141812	2718	chr12	16197157	16197226	AC102435.1	+	69	55345
chr12	16141996	16143161	1165	chr12	16197157	16197226	AC102435.1	+	69	53996
chr12	16380751	16382494	1743	chr12	16542475	16596576	Lpin1	-	54101	159981
chr12	16388636	16394216	5580	chr12	16542475	16596576	Lpin1	-	54101	148259
chr12	16876999	16878528	1529	chr12	16901784	16995080	Rock2	+	93296	23256
chr12	17039426	17040426	1000	chr12	17011764	17018360	2410004P03Rik	-	6596	21066
chr12	17046496	17047554	1058	chr12	17011764	17018360	2410004P03Rik	-	6596	28136
chr12	17460157	17462119	1962	chr12	17355285	17437381	Nol10	+	82096	22776
chr12	17511528	17515984	4456	chr12	17551679	17558308	Odc1	+	6629	35695
chr12	17590117	17591117	1000	chr12	17551679	17558308	Odc1	+	6629	31809
chr12	17596564	17599080	2516	chr12	17551679	17558308	Odc1	+	6629	38256
chr12	21467325	21470220	2895	chr12	21423772	21425664	Gm4419	+	1892	41661
chr12	21548672	21549757	1085	chr12	21423772	21425664	Gm4419	+	1892	123008
chr12	25866526	25867526	1000	chr12	25778666	25780957	Id2	-	2291	85569
chr12	25873449	25876341	2892	chr12	25778666	25780957	Id2	-	2291	92492
chr12	25892922	25896820	3898	chr12	25778666	25780957	Id2	-	2291	111965
chr12	25897866	25899664	1798	chr12	25778666	25780957	Id2	-	2291	116909
chr12	25924399	25925399	1000	chr12	25778666	25780957	Id2	-	2291	143442
chr12	25939525	25940545	1020	chr12	25778666	25780957	Id2	-	2291	158568
chr12	25984436	25985436	1000	chr12	25778666	25780957	Id2	-	2291	203479
chr12	25990590	25991652	1062	chr12	25778666	25780957	Id2	-	2291	209633
chr12	26112507	26114308	1801	chr12	26372666	26372771	5S_rRNA	+	105	258358
chr12	26114971	26115996	1025	chr12	26372666	26372771	5S_rRNA	+	105	256670
chr12	26122556	26125115	2559	chr12	26372666	26372771	5S_rRNA	+	105	247551
chr12	26740590	26747629	7039	chr12	26991662	27100121	Rnf144a	-	108459	244033
chr12	26752547	26754229	1682	chr12	26991662	27100121	Rnf144a	-	108459	237433
chr12	26869560	26870560	1000	chr12	26991662	27100121	Rnf144a	-	108459	121102
chr12	29975203	29976203	1000	chr12	30213249	30608074	Myt1l	+	394825	237046
chr12	32920708	32922634	1926	chr12	32858338	32893524	Pik3cg	-	35186	27184
chr12	32976644	32978021	1377	chr12	33039750	33040067	7SK	-	317	61729
chr12	32990471	32991616	1145	chr12	33039750	33040067	7SK	-	317	48134
chr12	33028342	33029880	1538	chr12	33039750	33040067	7SK	-	317	9870
chr12	33087096	33088096	1000	chr12	33063569	33067808	2010109K11Rik	+	4239	19288
chr12	33319809	33320809	1000	chr12	33282246	33284111	Gm4511	+	1865	35698
chr12	33326648	33327676	1028	chr12	33282246	33284111	Gm4511	+	1865	42537
chr12	33380668	33382712	2044	chr12	33282246	33284111	Gm4511	+	1865	96557
chr12	33458715	33459841	1126	chr12	33505200	33538234	Nampt	+	33034	45359
chr12	33480246	33481246	1000	chr12	33505200	33538234	Nampt	+	33034	23954
chr12	33670171	33672225	2054	chr12	33638756	33663915	Sypl	+	25159	6256
chr12	33701629	33702629	1000	chr12	33718661	33777740	Cdhr3	-	59079	16032
chr12	35364863	35366459	1596	chr12	34732451	35213754	Hdac9	-	481303	151109
chr12	35407245	35408557	1312	chr12	35558427	35559525	4921508M14Rik	-	1098	149870
chr12	35463994	35465010	1016	chr12	35558427	35559525	4921508M14Rik	-	1098	93417
chr12	35468018	35469222	1204	chr12	35558427	35559525	4921508M14Rik	-	1098	89205
chr12	35722997	35724537	1540	chr12	35731861	35832141	Snx13	+	100280	7324
chr12	36022608	36024693	2085	chr12	36125862	36125968	U6	+	106	101169
chr12	36146614	36149106	2492	chr12	36125862	36125968	U6	+	106	20646
chr12	36236706	36239655	2949	chr12	36182646	36219710	Ahr	-	37064	16996
chr12	36247402	36248750	1348	chr12	36182646	36219710	Ahr	-	37064	27692
chr12	36248792	36250218	1426	chr12	36182646	36219710	Ahr	-	37064	29082
chr12	36306993	36309628	2635	chr12	36182646	36219710	Ahr	-	37064	87283
chr12	36322740	36323836	1096	chr12	36182646	36219710	Ahr	-	37064	103030
chr12	36324970	36326996	2026	chr12	36182646	36219710	Ahr	-	37064	105260
chr12	36395478	36397715	2237	chr12	36182646	36219710	Ahr	-	37064	175768
chr12	36553487	36558373	4886	chr12	36652207	36676323	Agr3	+	24116	93834
chr12	36558945	36560954	2009	chr12	36652207	36676323	Agr3	+	24116	91253
chr12	37051195	37053897	2702	chr12	37040756	37045039	Sostdc1	+	4283	6156
chr12	41593994	41595954	1960	chr12	41172640	41573073	Dock4	+	400433	20921
chr12	41596202	41598731	2529	chr12	41172640	41573073	Dock4	+	400433	23129
chr12	43092472	43093472	1000	chr12	41750677	43056575	Immp2l	+	1305898	35897
chr12	49611748	49613619	1871	chr12	49655169	49660958	Gm1818	-	5789	41550
chr12	52945327	52946999	1672	chr12	52844709	52930523	Hectd1	-	85814	14804
chr12	52965535	52968933	3398	chr12	52976860	53072308	Heatr5a	-	95448	7927
chr12	53581882	53584338	2456	chr12	53617064	53668839	Arhgap5	+	51775	32726
chr12	53716129	53717129	1000	chr12	53705472	53705578	U6	-	106	10551
chr12	55392474	55395359	2885	chr12	55341742	55341887	U1	-	145	50587
chr12	55399877	55400898	1021	chr12	55341742	55341887	U1	-	145	57990
chr12	55405061	55406061	1000	chr12	55341742	55341887	U1	-	145	63174
chr12	55413511	55414918	1407	chr12	55341742	55341887	U1	-	145	71624
chr12	55417712	55418918	1206	chr12	55341742	55341887	U1	-	145	75825
chr12	55920997	55922756	1759	chr12	55847336	55896690	Snx6	-	49354	24307
chr12	55935699	55936893	1194	chr12	55959804	55963864	Cfl2	-	4060	22911
chr12	56530413	56531867	1454	chr12	56485209	56519441	Psma6	+	34232	10972
chr12	56531916	56534329	2413	chr12	56485209	56519441	Psma6	+	34232	12475
chr12	56534360	56535977	1617	chr12	56485209	56519441	Psma6	+	34232	14919
chr12	56539208	56542641	3433	chr12	56485209	56519441	Psma6	+	34232	19767
chr12	56543382	56546610	3228	chr12	56485209	56519441	Psma6	+	34232	23941
chr12	56553571	56554931	1360	chr12	56485209	56519441	Psma6	+	34232	34130
chr12	56559583	56560583	1000	chr12	56590398	56593634	Nfkbia	-	3236	29815
chr12	56565077	56567068	1991	chr12	56590398	56593634	Nfkbia	-	3236	23330
chr12	56574648	56576108	1460	chr12	56590398	56593634	Nfkbia	-	3236	14290
chr12	56599457	56600524	1067	chr12	56590398	56593634	Nfkbia	-	3236	5823
chr12	57054431	57056341	1910	chr12	57011808	57011910	U6	-	102	42521
chr12	57503760	57506383	2623	chr12	57474580	57474810	Gm6265	-	230	28950
chr12	58312301	58313420	1119	chr12	57813621	58298459	Slc25a21	-	484838	13842
chr12	60021132	60022163	1031	chr12	60054082	60068998	Gm17529	+	14916	31919
chr12	70486157	70487157	1000	chr12	70473137	70476966	Arf6	+	3829	9191
chr12	70502666	70504880	2214	chr12	70473137	70476966	Arf6	+	3829	25700
chr12	70515701	70516947	1246	chr12	70473137	70476966	Arf6	+	3829	38735
chr12	70517780	70519579	1799	chr12	70473137	70476966	Arf6	+	3829	40814
chr12	70519885	70521080	1195	chr12	70473137	70476966	Arf6	+	3829	42919
chr12	70523761	70524893	1132	chr12	70473137	70476966	Arf6	+	3829	46795
chr12	70558504	70560890	2386	chr12	70473137	70476966	Arf6	+	3829	81538
chr12	70562366	70563666	1300	chr12	70473137	70476966	Arf6	+	3829	85400
chr12	70575181	70576516	1335	chr12	70662216	70662324	AC153658.1	-	108	85700
chr12	70577341	70578533	1192	chr12	70662216	70662324	AC153658.1	-	108	83683
chr12	70586333	70587836	1503	chr12	70662216	70662324	AC153658.1	-	108	74380
chr12	70601848	70604105	2257	chr12	70662216	70662324	AC153658.1	-	108	58111
chr12	70613593	70615370	1777	chr12	70662216	70662324	AC153658.1	-	108	46846
chr12	70616874	70618007	1133	chr12	70662216	70662324	AC153658.1	-	108	44209
chr12	70638456	70640452	1996	chr12	70662216	70662324	AC153658.1	-	108	21764
chr12	70646555	70648089	1534	chr12	70662216	70662324	AC153658.1	-	108	14127
chr12	71236972	71238248	1276	chr12	71255129	71284334	Abhd12b	+	29205	16881
chr12	71249003	71250120	1117	chr12	71255129	71284334	Abhd12b	+	29205	5009
chr12	71807318	71809526	2208	chr12	71774633	71774733	U6	+	100	32585
chr12	71813884	71815547	1663	chr12	71774633	71774733	U6	+	100	39151
chr12	73114694	73115705	1011	chr12	72932065	73093354	Daam1	+	161289	21340
chr12	73944574	73946209	1635	chr12	73982096	74041820	4930447C04Rik	-	59724	35887
chr12	74942719	74943719	1000	chr12	75002362	75048517	Hif1a	+	46155	58643
chr12	74980981	74983503	2522	chr12	75002362	75048517	Hif1a	+	46155	18859
chr12	74988390	74990345	1955	chr12	75002362	75048517	Hif1a	+	46155	12017
chr12	78120846	78121846	1000	chr12	78038256	78063235	Max	-	24979	57611
chr12	78135344	78136344	1000	chr12	78038256	78063235	Max	-	24979	72109
chr12	78140160	78142739	2579	chr12	78217352	78217419	AC133174.1	-	67	74613
chr12	78160569	78161780	1211	chr12	78217352	78217419	AC133174.1	-	67	55572
chr12	78184885	78188241	3356	chr12	78217352	78217419	AC133174.1	-	67	29111
chr12	78270439	78272344	1905	chr12	78217352	78217419	AC133174.1	-	67	53020
chr12	78296858	78300477	3619	chr12	78340052	78577325	Fut8	+	237273	39575
chr12	79241771	79244289	2518	chr12	79266533	79266653	SNORA17	+	120	22244
chr12	79319691	79321908	2217	chr12	79327642	79785754	Gphn	+	458112	5734
chr12	80023185	80026374	3189	chr12	79989678	80007951	Plek2	-	18273	15234
chr12	80040406	80041406	1000	chr12	80062782	80108614	Tmem229b	-	45832	21376
chr12	80118374	80119763	1389	chr12	80062782	80108614	Tmem229b	-	45832	9760
chr12	80940818	80946192	5374	chr12	80398338	80904257	Rad51l1	+	505919	36561
chr12	80984647	80987274	2627	chr12	80398338	80904257	Rad51l1	+	505919	80390
chr12	81025694	81027932	2238	chr12	80398338	80904257	Rad51l1	+	505919	121437
chr12	81065958	81067256	1298	chr12	81208747	81214000	Zfp36l1	-	5253	141491
chr12	81071075	81072075	1000	chr12	81208747	81214000	Zfp36l1	-	5253	136672
chr12	81083366	81085483	2117	chr12	81208747	81214000	Zfp36l1	-	5253	123264
chr12	81091390	81093248	1858	chr12	81208747	81214000	Zfp36l1	-	5253	115499
chr12	81101969	81103048	1079	chr12	81208747	81214000	Zfp36l1	-	5253	105699
chr12	81115146	81116446	1300	chr12	81208747	81214000	Zfp36l1	-	5253	92301
chr12	81121481	81122619	1138	chr12	81208747	81214000	Zfp36l1	-	5253	86128
chr12	81123585	81124585	1000	chr12	81208747	81214000	Zfp36l1	-	5253	84162
chr12	81154329	81156274	1945	chr12	81208747	81214000	Zfp36l1	-	5253	52473
chr12	81160951	81162085	1134	chr12	81208747	81214000	Zfp36l1	-	5253	46662
chr12	81163499	81168883	5384	chr12	81208747	81214000	Zfp36l1	-	5253	39864
chr12	81169282	81172774	3492	chr12	81208747	81214000	Zfp36l1	-	5253	35973
chr12	81248240	81249240	1000	chr12	81221535	81233831	2310015A10Rik	-	12296	14409
chr12	81386259	81387259	1000	chr12	81374773	81376217	Gm17301	-	1444	10042
chr12	82039608	82040767	1159	chr12	82046491	82051494	Srsf5	+	5003	5724
chr12	82775857	82776857	1000	chr12	82732356	82765928	Ttc9	+	33572	9929
chr12	82908025	82909025	1000	chr12	82815937	82882157	Map3k9	-	66220	25868
chr12	83570042	83572510	2468	chr12	83270407	83552769	Sipa1l1	+	282362	17273
chr12	84827961	84828961	1000	chr12	84861416	84882938	Dcaf4	+	21522	32455
chr12	85586025	85588006	1981	chr12	85599282	85599923	Gm5436	-	641	11276
chr12	86783794	86784794	1000	chr12	86814840	86818223	Fos	+	3383	30046
chr12	86785145	86786571	1426	chr12	86814840	86818223	Fos	+	3383	28269
chr12	86787022	86789363	2341	chr12	86814840	86818223	Fos	+	3383	25477
chr12	86795373	86797281	1908	chr12	86814840	86818223	Fos	+	3383	17559
chr12	86826028	86827813	1785	chr12	86814840	86818223	Fos	+	3383	7805
chr12	86886260	86887260	1000	chr12	86940366	86980827	Jdp2	+	40461	53106
chr12	86911728	86913430	1702	chr12	86940366	86980827	Jdp2	+	40461	26936
chr12	86929812	86934966	5154	chr12	86940366	86980827	Jdp2	+	40461	5400
chr12	87001279	87002809	1530	chr12	86940366	86980827	Jdp2	+	40461	20452
chr12	87003683	87005562	1879	chr12	87027619	87050037	Batf	+	22418	22057
chr12	87005985	87007121	1136	chr12	87027619	87050037	Batf	+	22418	20498
chr12	87010457	87011533	1076	chr12	87027619	87050037	Batf	+	22418	16086
chr12	87019636	87021885	2249	chr12	87027619	87050037	Batf	+	22418	5734
chr12	87066833	87068884	2051	chr12	87059427	87059545	n-R5s64	-	118	7288
chr12	87069701	87071321	1620	chr12	87059427	87059545	n-R5s64	-	118	10156
chr12	88136157	88137285	1128	chr12	88150907	88151208	7SK	+	301	13622
chr12	88141015	88143884	2869	chr12	88150907	88151208	7SK	+	301	7023
chr12	88164232	88167184	2952	chr12	88150907	88151208	7SK	+	301	13024
chr12	88174170	88175907	1737	chr12	88150907	88151208	7SK	+	301	22962
chr12	88176817	88177959	1142	chr12	88150907	88151208	7SK	+	301	25609
chr12	88199320	88202027	2707	chr12	88221653	88225764	6430527G18Rik	-	4111	19626
chr12	89710165	89711165	1000	chr12	89598998	89700163	Adck1	+	101165	10002
chr12	94121968	94123468	1500	chr12	93399333	93399770	Gm2228	-	437	722198
chr12	94130416	94131669	1253	chr12	93399333	93399770	Gm2228	-	437	730646
chr12	99521183	99522214	1031	chr12	99506845	99514834	Gpr65	+	7989	6349
chr12	99528569	99529658	1089	chr12	99506845	99514834	Gpr65	+	7989	13735
chr12	99549286	99550925	1639	chr12	99506845	99514834	Gpr65	+	7989	34452
chr12	99608306	99609860	1554	chr12	99672204	99816150	Kcnk10	-	143946	62344
chr12	99844235	99845235	1000	chr12	99837243	99837305	U7	+	62	6930
chr12	100695170	100697098	1928	chr12	100433190	100688321	Foxn3	-	255131	6849
chr12	100699654	100701964	2310	chr12	100433190	100688321	Foxn3	-	255131	11333
chr12	100704514	100708138	3624	chr12	100433190	100688321	Foxn3	-	255131	16193
chr12	100734725	100735725	1000	chr12	100433190	100688321	Foxn3	-	255131	46404
chr12	100747559	100750868	3309	chr12	100802051	100858248	Gm16956	+	56197	51183
chr12	100782137	100785023	2886	chr12	100802051	100858248	Gm16956	+	56197	17028
chr12	100786066	100787210	1144	chr12	100802051	100858248	Gm16956	+	56197	14841
chr12	100863737	100864737	1000	chr12	100802051	100858248	Gm16956	+	56197	5489
chr12	100865062	100866459	1397	chr12	100802051	100858248	Gm16956	+	56197	6814
chr12	100881029	100886125	5096	chr12	100802051	100858248	Gm16956	+	56197	22781
chr12	100924193	100925312	1119	chr12	100955741	101121652	2610021K21Rik	-	165911	30429
chr12	100926514	100927955	1441	chr12	100955741	101121652	2610021K21Rik	-	165911	27786
chr12	101321854	101323339	1485	chr12	101202709	101300892	Kcnk13	+	98183	20962
chr12	101328203	101329301	1098	chr12	101348396	101361574	Psmc1	+	13178	19095
chr12	101405754	101408537	2783	chr12	101363662	101397863	BC002230	-	34201	7891
chr12	101514286	101516186	1900	chr12	101538981	101759032	Ttc7b	-	220051	22795
chr12	101520266	101521433	1167	chr12	101538981	101759032	Ttc7b	-	220051	17548
chr12	101777026	101778200	1174	chr12	101787988	101963238	Rps6ka5	-	175250	9788
chr12	101969194	101970893	1699	chr12	101787988	101963238	Rps6ka5	-	175250	5956
chr12	103320147	103321823	1676	chr12	103366016	103368116	Gm16339	-	2100	44193
chr12	103688975	103690065	1090	chr12	103632294	103678023	Lgmn	-	45729	10952
chr12	103690906	103692091	1185	chr12	103632294	103678023	Lgmn	-	45729	12883
chr12	103950820	103952228	1408	chr12	103806793	103943079	Itpk1	-	136286	7741
chr12	104510611	104511611	1000	chr12	104435118	104480360	Prima1	-	45242	30251
chr12	106257000	106258496	1496	chr12	106168159	106248019	4831426I19Rik	-	79860	8981
chr12	106259571	106260755	1184	chr12	106269285	106269559	Scarna13	-	274	8530
chr12	106712892	106714965	2073	chr12	106801382	106831281	Bdkrb2	+	29899	86417
chr12	107200828	107202165	1337	chr12	107248473	107315620	Vrk1	+	67147	46308
chr12	107204507	107206475	1968	chr12	107248473	107315620	Vrk1	+	67147	41998
chr12	107208787	107210756	1969	chr12	107248473	107315620	Vrk1	+	67147	37717
chr12	109995463	109996550	1087	chr12	110031183	110054842	Yy1	+	23659	34633
chr12	110000723	110001723	1000	chr12	110031183	110054842	Yy1	+	23659	29460
chr12	110305554	110307191	1637	chr12	110270397	110291589	Begain	-	21192	13965
chr12	110309456	110310977	1521	chr12	110270397	110291589	Begain	-	21192	17867
chr12	110311698	110313362	1664	chr12	110270397	110291589	Begain	-	21192	20109
chr12	111828954	111830918	1964	chr12	111685518	111821271	Ppp2r5c	+	135753	7683
chr12	111963016	111964090	1074	chr12	111976154	112042450	Wdr20a	+	66296	12064
chr12	112229075	112231156	2081	chr12	112213563	112217250	Ankrd9	-	3687	11825
chr12	112245261	112246921	1660	chr12	112213563	112217250	Ankrd9	-	3687	28011
chr12	112752838	112753838	1000	chr12	112776312	112794270	Eif5	+	17958	22474
chr12	113145524	113146648	1124	chr12	113066668	113110826	Ppp1r13b	-	44158	34698
chr12	113149584	113150967	1383	chr12	113066668	113110826	Ppp1r13b	-	44158	38758
chr12	113182489	113183489	1000	chr12	113199587	113205188	2010107E04Rik	-	5601	16098
chr12	113805822	113807069	1247	chr12	113826995	113853767	Inf2	+	26772	19926
chr12	113926433	113927637	1204	chr12	113917039	113920958	Zbtb42	+	3919	5475
chr12	113931049	113932564	1515	chr12	113917039	113920958	Zbtb42	+	3919	10091
chr12	113938965	113941926	2961	chr12	113917039	113920958	Zbtb42	+	3919	18007
chr12	114104431	114108525	4094	chr12	114089087	114099127	Gpr132	-	10040	5304
chr12	114110796	114112231	1435	chr12	114089087	114099127	Gpr132	-	10040	11669
chr12	114459575	114462534	2959	chr12	114452360	114452463	U6	+	103	7112
chr12	114465761	114466806	1045	chr12	114452360	114452463	U6	+	103	13298
chr12	114469630	114471586	1956	chr12	114452360	114452463	U6	+	103	17167
chr12	114471917	114473864	1947	chr12	114452360	114452463	U6	+	103	19454
chr12	114474011	114475136	1125	chr12	114452360	114452463	U6	+	103	21548
chr12	114480702	114481702	1000	chr12	114509391	114511457	Ighe	-	2066	27689
chr12	114482232	114484272	2040	chr12	114509391	114511457	Ighe	-	2066	25119
chr12	114491121	114492121	1000	chr12	114509391	114511457	Ighe	-	2066	17270
chr12	114494463	114496375	1912	chr12	114509391	114511457	Ighe	-	2066	13016
chr12	114532525	114533533	1008	chr12	114523536	114527141	Ighg2c	-	3605	5384
chr12	114551934	114553241	1307	chr12	114544600	114546144	Ighg2b	-	1544	5790
chr12	114557704	114560857	3153	chr12	114567187	114568734	Ighg1	-	1547	6330
chr12	114576822	114579219	2397	chr12	114567187	114568734	Ighg1	-	1547	8088
chr12	114581165	114583776	2611	chr12	114567187	114568734	Ighg1	-	1547	12431
chr12	115616473	115617596	1123	chr12	115604737	115605165	Ighv12-3	-	428	11308
chr12	118575419	118576419	1000	chr12	117724193	118516640	Ptprn2	+	792447	58779
chr12	118616822	118617822	1000	chr12	117724193	118516640	Ptprn2	+	792447	100182
chr12	118682409	118683971	1562	chr12	118754952	118995451	Rapgef5	+	240499	70981
chr12	118685060	118687036	1976	chr12	118754952	118995451	Rapgef5	+	240499	67916
chr12	119614353	119616073	1720	chr12	119473406	119539913	Sp4	-	66507	74440
chr12	120720787	120724082	3295	chr12	120681883	120705407	Macc1	+	23524	15380
chr12	12179212	12180381	1169	chr12	12113543	12113673	5S_rRNA	+	130	65539
chr12	16048124	16049124	1000	chr12	16197157	16197226	AC102435.1	+	69	148033
chr12	16431623	16432623	1000	chr12	16542475	16596576	Lpin1	-	54101	109852
chr12	16533107	16536438	3331	chr12	16542475	16596576	Lpin1	-	54101	6037
chr12	18616580	18617679	1099	chr12	18521544	18540997	5730507C01Rik	+	19453	75583
chr12	25849845	25851724	1879	chr12	25778666	25780957	Id2	-	2291	68888
chr12	25867630	25868692	1062	chr12	25778666	25780957	Id2	-	2291	86673
chr12	25901810	25902810	1000	chr12	25778666	25780957	Id2	-	2291	120853
chr12	25996606	25998509	1903	chr12	25778666	25780957	Id2	-	2291	215649
chr12	26121178	26122178	1000	chr12	26372666	26372771	5S_rRNA	+	105	250488
chr12	27209699	27211024	1325	chr12	27154069	27164700	Cmpk2	+	10631	44999
chr12	32772259	32773259	1000	chr12	32643341	32746161	Prkar2b	-	102820	26098
chr12	33024282	33025843	1561	chr12	33039750	33040067	7SK	-	317	13907
chr12	35267542	35268542	1000	chr12	34732451	35213754	Hdac9	-	481303	53788
chr12	35398292	35399498	1206	chr12	35558427	35559525	4921508M14Rik	-	1098	158929
chr12	36406550	36407632	1082	chr12	36182646	36219710	Ahr	-	37064	186840
chr12	43352022	43353022	1000	chr12	43382703	43382800	AC154353.1	+	97	29681
chr12	53604699	53605811	1112	chr12	53617064	53668839	Arhgap5	+	51775	11253
chr12	56128174	56129174	1000	chr12	55993976	56115335	Baz1a	-	121359	12839
chr12	56536370	56537370	1000	chr12	56485209	56519441	Psma6	+	34232	16929
chr12	56547513	56548596	1083	chr12	56485209	56519441	Psma6	+	34232	28072
chr12	56568779	56570423	1644	chr12	56590398	56593634	Nfkbia	-	3236	19975
chr12	70548111	70549979	1868	chr12	70473137	70476966	Arf6	+	3829	71145
chr12	70611929	70613346	1417	chr12	70662216	70662324	AC153658.1	-	108	48870
chr12	78278817	78280368	1551	chr12	78340052	78577325	Fut8	+	237273	59684
chr12	78799174	78800213	1039	chr12	78915667	78915796	SNORA17	-	129	115454
chr12	79306974	79307974	1000	chr12	79327642	79785754	Gphn	+	458112	19668
chr12	81061008	81062064	1056	chr12	81208747	81214000	Zfp36l1	-	5253	146683
chr12	81076008	81077183	1175	chr12	81208747	81214000	Zfp36l1	-	5253	131564
chr12	81876935	81878062	1127	chr12	81891546	81981819	4933426M11Rik	+	90273	13484
chr12	85583976	85585180	1204	chr12	85599282	85599923	Gm5436	-	641	14102
chr12	86873579	86875172	1593	chr12	86814840	86818223	Fos	+	3383	55356
chr12	91814624	91815624	1000	chr12	91962994	91976878	Dio2	-	13884	147370
chr12	94120290	94121390	1100	chr12	93399333	93399770	Gm2228	-	437	720520
chr12	100878659	100879752	1093	chr12	100802051	100858248	Gm16956	+	56197	20411
chr12	101765926	101767797	1871	chr12	101538981	101759032	Ttc7b	-	220051	6894
chr12	105305046	105306383	1337	chr12	105318859	105324934	Serpina4-ps1	+	6075	12476
chr12	110003214	110004457	1243	chr12	110031183	110054842	Yy1	+	23659	26726
chr12	113127427	113128733	1306	chr12	113066668	113110826	Ppp1r13b	-	44158	16601
chr12	113184341	113185476	1135	chr12	113199587	113205188	2010107E04Rik	-	5601	14111
chr12	114466851	114467851	1000	chr12	114452360	114452463	U6	+	103	14388
chr12	114475340	114476938	1598	chr12	114452360	114452463	U6	+	103	22877
chr12	114492490	114493591	1101	chr12	114509391	114511457	Ighe	-	2066	15800
chr12	120352262	120353276	1014	chr12	120396495	120477275	Itgb8	-	80780	43219
chr13	3524874	3526599	1725	chr13	3537321	3565507	Gdi2	+	28186	10722
chr13	3781033	3782033	1000	chr13	3802139	3803564	Calml3	-	1425	20106
chr13	5712337	5714386	2049	chr13	5860735	5869639	Klf6	+	8904	146349
chr13	5722764	5724829	2065	chr13	5860735	5869639	Klf6	+	8904	135906
chr13	5765533	5770998	5465	chr13	5860735	5869639	Klf6	+	8904	89737
chr13	5777464	5783034	5570	chr13	5860735	5869639	Klf6	+	8904	77701
chr13	5787862	5789624	1762	chr13	5860735	5869639	Klf6	+	8904	71111
chr13	5836518	5837645	1127	chr13	5860735	5869639	Klf6	+	8904	23090
chr13	5844230	5845348	1118	chr13	5860735	5869639	Klf6	+	8904	15387
chr13	5887048	5889438	2390	chr13	5860735	5869639	Klf6	+	8904	17409
chr13	5937693	5940090	2397	chr13	5996701	5996797	AC154816.1	-	96	56611
chr13	6125876	6128309	2433	chr13	5996701	5996797	AC154816.1	-	96	129079
chr13	6158131	6159712	1581	chr13	5996701	5996797	AC154816.1	-	96	161334
chr13	6887571	6889619	2048	chr13	6661765	6662187	Gm10029	-	422	225384
chr13	8877897	8878897	1000	chr13	8884747	8891697	Idi1	+	6950	5850
chr13	9178582	9180678	2096	chr13	9093151	9172332	Larp4b	+	79181	6250
chr13	9774794	9776119	1325	chr13	9684082	9764567	Zmynd11	-	80485	10227
chr13	12772313	12773313	1000	chr13	12758318	12758581	7SK	+	263	13732
chr13	12809651	12811572	1921	chr13	12794629	12794856	Gm2399	+	227	14795
chr13	13615876	13617647	1771	chr13	13529869	13604542	Nid1	+	74673	11334
chr13	13620952	13622171	1219	chr13	13529869	13604542	Nid1	+	74673	16410
chr13	16352133	16354270	2137	chr13	16132879	16132985	U6	-	106	219148
chr13	16733255	16734315	1060	chr13	16930969	16931094	AC154368.1	-	125	196654
chr13	17908242	17909242	1000	chr13	17901425	17901531	U6	-	106	6711
chr13	18066779	18069259	2480	chr13	18078474	18085185	1600012F09Rik	-	6711	9215
chr13	19507404	19509056	1652	chr13	19449546	19487621	Stard3nl	-	38075	19783
chr13	19509579	19511210	1631	chr13	19449546	19487621	Stard3nl	-	38075	21958
chr13	20141360	20142360	1000	chr13	20182488	20698397	Elmo1	+	515909	40128
chr13	21259260	21262282	3022	chr13	21271314	21286593	Trim27	+	15279	9032
chr13	21263281	21264488	1207	chr13	21271314	21286593	Trim27	+	15279	6826
chr13	21499716	21501130	1414	chr13	21478874	21494624	Zkscan3	-	15750	5092
chr13	21943350	21944952	1602	chr13	21925612	21929399	Hist1h2br	+	3787	13951
chr13	22010204	22011369	1165	chr13	21995025	21996653	Gm11279	+	1628	13551
chr13	22087043	22088043	1000	chr13	22094045	22101611	Prss16	-	7566	6002
chr13	23528725	23530931	2206	chr13	23519844	23522891	C230035I16Rik	-	3047	5834
chr13	23608285	23611747	3462	chr13	23618880	23622812	Gm11335	-	3932	7133
chr13	24592954	24594224	1270	chr13	24578531	24578633	U6	-	102	14321
chr13	24603269	24604269	1000	chr13	24578531	24578633	U6	-	102	24636
chr13	24877342	24878471	1129	chr13	24893526	24905882	BC005537	+	12356	15055
chr13	30094341	30095409	1068	chr13	29998444	30077537	E2f3	-	79093	16804
chr13	30176257	30177352	1095	chr13	30150546	30154840	Gm11368	+	4294	21417
chr13	30664062	30665062	1000	chr13	30632177	30637231	Uqcrfs1	-	5054	26831
chr13	30685439	30687668	2229	chr13	30706912	30716128	4930519D14Rik	+	9216	19244
chr13	30695050	30697676	2626	chr13	30706912	30716128	4930519D14Rik	+	9216	9236
chr13	30721155	30722687	1532	chr13	30706912	30716128	4930519D14Rik	+	9216	5027
chr13	30723360	30725310	1950	chr13	30706912	30716128	4930519D14Rik	+	9216	7232
chr13	30728035	30731578	3543	chr13	30706912	30716128	4930519D14Rik	+	9216	11907
chr13	30811375	30816120	4745	chr13	30823646	30823905	Gm11370	+	259	7526
chr13	30873700	30875204	1504	chr13	30841095	30858796	Irf4	+	17701	14904
chr13	30877379	30880989	3610	chr13	30841095	30858796	Irf4	+	17701	18583
chr13	30883499	30885298	1799	chr13	30905788	31065916	Exoc2	-	160128	20490
chr13	32600904	32602673	1769	chr13	32471776	32475557	Gm11381	-	3781	125347
chr13	32702567	32704296	1729	chr13	32792696	32875823	Mylk4	-	83127	88400
chr13	32704588	32705986	1398	chr13	32792696	32875823	Mylk4	-	83127	86710
chr13	32751720	32753038	1318	chr13	32792696	32875823	Mylk4	-	83127	39658
chr13	32761919	32763645	1726	chr13	32792696	32875823	Mylk4	-	83127	29051
chr13	32771360	32773302	1942	chr13	32792696	32875823	Mylk4	-	83127	19394
chr13	32783348	32786473	3125	chr13	32792696	32875823	Mylk4	-	83127	6223
chr13	32923686	32925704	2018	chr13	32933961	32943054	Serpinb1a	-	9093	8257
chr13	32998750	33001179	2429	chr13	32973702	32990030	Serpinb1c	-	16328	8720
chr13	33020309	33022143	1834	chr13	33030393	33030560	Gm11382	-	167	8250
chr13	33083956	33087379	3423	chr13	33095119	33109826	Serpinb9	+	14707	7740
chr13	33088481	33089554	1073	chr13	33095119	33109826	Serpinb9	+	14707	5565
chr13	33159370	33161465	2095	chr13	33175994	33186249	Serpinb1b	+	10255	14529
chr13	33164143	33166127	1984	chr13	33175994	33186249	Serpinb1b	+	10255	9867
chr13	33650153	33652853	2700	chr13	33659663	33659874	RNaseP_nuc	+	211	6810
chr13	33652880	33653948	1068	chr13	33659663	33659874	RNaseP_nuc	+	211	5715
chr13	34775100	34776393	1293	chr13	34744792	34758643	Gm15908	+	13851	16457
chr13	34796218	34797870	1652	chr13	34826719	34839482	Fam50b	+	12763	28849
chr13	35220899	35224688	3789	chr13	35069617	35118963	Eci2	-	49346	101936
chr13	35280233	35281962	1729	chr13	35385016	35385146	SNORA17	-	130	103054
chr13	35300776	35302455	1679	chr13	35385016	35385146	SNORA17	-	130	82561
chr13	35474899	35476644	1745	chr13	35385016	35385146	SNORA17	-	130	89753
chr13	35603160	35604160	1000	chr13	35751731	35965933	Cdyl	+	214202	147571
chr13	37382009	37384245	2236	chr13	37437214	37510905	Ly86	+	73691	52969
chr13	37423217	37426340	3123	chr13	37437214	37510905	Ly86	+	73691	10874
chr13	37429044	37430044	1000	chr13	37437214	37510905	Ly86	+	73691	7170
chr13	37531677	37532688	1011	chr13	37437214	37510905	Ly86	+	73691	20772
chr13	37542851	37545229	2378	chr13	37437214	37510905	Ly86	+	73691	31946
chr13	37567739	37569645	1906	chr13	37437214	37510905	Ly86	+	73691	56834
chr13	37633402	37634402	1000	chr13	37437214	37510905	Ly86	+	73691	122497
chr13	37711129	37712496	1367	chr13	37870269	38043871	Rreb1	+	173602	157773
chr13	37746050	37747050	1000	chr13	37870269	38043871	Rreb1	+	173602	123219
chr13	37748771	37750402	1631	chr13	37870269	38043871	Rreb1	+	173602	119867
chr13	37763830	37764830	1000	chr13	37870269	38043871	Rreb1	+	173602	105439
chr13	37765948	37767725	1777	chr13	37870269	38043871	Rreb1	+	173602	102544
chr13	37771889	37773536	1647	chr13	37870269	38043871	Rreb1	+	173602	96733
chr13	37777938	37778938	1000	chr13	37870269	38043871	Rreb1	+	173602	91331
chr13	37782913	37784905	1992	chr13	37870269	38043871	Rreb1	+	173602	85364
chr13	38637559	38639138	1579	chr13	38591948	38620693	Txndc5	-	28745	16866
chr13	41597647	41598754	1107	chr13	41405285	41582689	Nedd9	-	177404	14958
chr13	41610628	41611628	1000	chr13	41405285	41582689	Nedd9	-	177404	27939
chr13	41616124	41617124	1000	chr13	41405285	41582689	Nedd9	-	177404	33435
chr13	41633804	41636474	2670	chr13	41673278	41673443	AC154848.1	-	165	36804
chr13	41678594	41679934	1340	chr13	41673278	41673443	AC154848.1	-	165	5151
chr13	41765883	41768298	2415	chr13	41749014	41752146	Gm5082	+	3132	13737
chr13	41975301	41980208	4907	chr13	41997020	41997123	U6	+	103	16812
chr13	42338997	42339997	1000	chr13	42396639	42403358	Edn1	+	6719	56642
chr13	42340931	42342040	1109	chr13	42396639	42403358	Edn1	+	6719	54599
chr13	42352578	42354831	2253	chr13	42396639	42403358	Edn1	+	6719	41808
chr13	42462721	42463721	1000	chr13	42396639	42403358	Edn1	+	6719	59363
chr13	43845629	43846805	1176	chr13	43880476	43898499	Cd83	+	18023	33671
chr13	43862890	43864468	1578	chr13	43880476	43898499	Cd83	+	18023	16008
chr13	43871947	43873092	1145	chr13	43880476	43898499	Cd83	+	18023	7384
chr13	43959193	43961079	1886	chr13	43968171	43968278	U6	+	107	7092
chr13	43993334	43997056	3722	chr13	43968171	43968278	U6	+	107	25056
chr13	44053906	44055433	1527	chr13	43968171	43968278	U6	+	107	85628
chr13	44160492	44162151	1659	chr13	44216536	44220548	Gm5083	+	4012	54385
chr13	44387702	44388805	1103	chr13	44216536	44220548	Gm5083	+	4012	167154
chr13	44415575	44417750	2175	chr13	44216536	44220548	Gm5083	+	4012	195027
chr13	44511724	44512724	1000	chr13	44216536	44220548	Gm5083	+	4012	291176
chr13	44514369	44515369	1000	chr13	44216536	44220548	Gm5083	+	4012	293821
chr13	44549992	44550992	1000	chr13	44824843	45017012	Jarid2	+	192169	273851
chr13	44564398	44565991	1593	chr13	44824843	45017012	Jarid2	+	192169	258852
chr13	44599467	44600697	1230	chr13	44824843	45017012	Jarid2	+	192169	224146
chr13	44600747	44602338	1591	chr13	44824843	45017012	Jarid2	+	192169	222505
chr13	44611484	44614618	3134	chr13	44824843	45017012	Jarid2	+	192169	210225
chr13	44629814	44631696	1882	chr13	44824843	45017012	Jarid2	+	192169	193147
chr13	44633567	44634678	1111	chr13	44824843	45017012	Jarid2	+	192169	190165
chr13	44639325	44641870	2545	chr13	44824843	45017012	Jarid2	+	192169	182973
chr13	44675537	44676998	1461	chr13	44824843	45017012	Jarid2	+	192169	147845
chr13	44679248	44680341	1093	chr13	44824843	45017012	Jarid2	+	192169	144502
chr13	45203090	45204618	1528	chr13	45174061	45176591	Gm9817	+	2530	26499
chr13	45513695	45514695	1000	chr13	45485111	45507388	Mylip	+	22277	6307
chr13	45537916	45539842	1926	chr13	45485111	45507388	Mylip	+	22277	30528
chr13	45548496	45551587	3091	chr13	45581593	45581699	U6	-	106	30006
chr13	46137465	46139412	1947	chr13	46060622	46061869	5033430I15Rik	+	1247	75596
chr13	46193122	46194122	1000	chr13	46270797	46286417	Gm10113	-	15620	76675
chr13	46248682	46249682	1000	chr13	46270797	46286417	Gm10113	-	15620	21115
chr13	46434788	46436310	1522	chr13	46369090	46395484	Gm1574	+	26394	39304
chr13	48647109	48648533	1424	chr13	48633548	48633641	Mirlet7a-1	-	93	13468
chr13	49073072	49074198	1126	chr13	49063656	49067400	C030044B11Rik	+	3744	5672
chr13	51168148	51170587	2439	chr13	51196267	51247915	Spin1	+	51648	25680
chr13	51410299	51412221	1922	chr13	51503987	51518166	S1pr3	+	14179	91766
chr13	51481485	51485082	3597	chr13	51503987	51518166	S1pr3	+	14179	18905
chr13	51492512	51493512	1000	chr13	51503987	51518166	S1pr3	+	14179	10475
chr13	51908600	51911014	2414	chr13	51796615	51889116	Sema4d	-	92501	19484
chr13	52031180	52032249	1069	chr13	52068583	52071952	Gm16767	+	3369	36334
chr13	52058932	52060638	1706	chr13	52068583	52071952	Gm16767	+	3369	7945
chr13	52090764	52091764	1000	chr13	52068583	52071952	Gm16767	+	3369	18812
chr13	52119562	52121204	1642	chr13	52068583	52071952	Gm16767	+	3369	47610
chr13	52156640	52158503	1863	chr13	52068583	52071952	Gm16767	+	3369	84688
chr13	52173842	52175151	1309	chr13	52068583	52071952	Gm16767	+	3369	101890
chr13	52178476	52181272	2796	chr13	52068583	52071952	Gm16767	+	3369	106524
chr13	52195118	52196202	1084	chr13	52068583	52071952	Gm16767	+	3369	123166
chr13	52233444	52235939	2495	chr13	52068583	52071952	Gm16767	+	3369	161492
chr13	52246972	52249998	3026	chr13	52068583	52071952	Gm16767	+	3369	175020
chr13	52250468	52252158	1690	chr13	52068583	52071952	Gm16767	+	3369	178516
chr13	52257110	52261312	4202	chr13	52068583	52071952	Gm16767	+	3369	185158
chr13	52330844	52332324	1480	chr13	52068583	52071952	Gm16767	+	3369	258892
chr13	52400675	52402150	1475	chr13	52599744	52626205	Diras2	-	26461	197594
chr13	52539965	52542435	2470	chr13	52599744	52626205	Diras2	-	26461	57309
chr13	52633136	52635043	1907	chr13	52599744	52626205	Diras2	-	26461	6931
chr13	52660254	52661269	1015	chr13	52678542	52744161	Syk	+	65619	17273
chr13	52667282	52668978	1696	chr13	52678542	52744161	Syk	+	65619	9564
chr13	52752692	52753900	1208	chr13	52678542	52744161	Syk	+	65619	8531
chr13	52807125	52808288	1163	chr13	52678542	52744161	Syk	+	65619	62964
chr13	52816611	52817819	1208	chr13	52678542	52744161	Syk	+	65619	72450
chr13	52885734	52887441	1707	chr13	52930488	53025050	Auh	-	94562	43047
chr13	52892164	52897355	5191	chr13	52930488	53025050	Auh	-	94562	33133
chr13	52900893	52903466	2573	chr13	52930488	53025050	Auh	-	94562	27022
chr13	52903567	52906897	3330	chr13	52930488	53025050	Auh	-	94562	23591
chr13	53093409	53094876	1467	chr13	53062578	53076442	Nfil3	-	13864	16967
chr13	53119147	53120812	1665	chr13	53062578	53076442	Nfil3	-	13864	42705
chr13	54591284	54592284	1000	chr13	54601066	54601450	Gm16247	-	384	8782
chr13	55283340	55284534	1194	chr13	55254001	55270120	Fgfr4	+	16119	13220
chr13	55290801	55291986	1185	chr13	55311143	55419686	Nsd1	+	108543	19157
chr13	56296615	56299106	2491	chr13	56275064	56280246	Tifab	-	5182	16369
chr13	62659263	62660273	1010	chr13	62644794	62644863	SNORA32	-	69	14400
chr13	62754045	62755065	1020	chr13	62725554	62725661	CT030240.1	+	107	28384
chr13	62785293	62787072	1779	chr13	62800766	62828049	Gm5665	-	27283	13694
chr13	62886322	62887428	1106	chr13	62880954	62881036	AC156572.1	+	82	5286
chr13	63050466	63051466	1000	chr13	63066253	63427404	2010111I01Rik	+	361151	14787
chr13	63053083	63054083	1000	chr13	63066253	63427404	2010111I01Rik	+	361151	12170
chr13	63693443	63695643	2200	chr13	63610261	63674474	Ptch1	-	64213	18969
chr13	63705303	63706303	1000	chr13	63610261	63674474	Ptch1	-	64213	30829
chr13	63733107	63734107	1000	chr13	63610261	63674474	Ptch1	-	64213	58633
chr13	63802359	63804944	2585	chr13	63916548	64001610	0610007P08Rik	+	85062	111604
chr13	63819880	63820880	1000	chr13	63916548	64001610	0610007P08Rik	+	85062	95668
chr13	63862296	63863296	1000	chr13	63916548	64001610	0610007P08Rik	+	85062	53252
chr13	63908156	63909156	1000	chr13	63916548	64001610	0610007P08Rik	+	85062	7392
chr13	64152558	64153558	1000	chr13	64159582	64190509	Hsd17b3	-	30927	6024
chr13	74527566	74528676	1110	chr13	74508874	74514014	Zfp72	-	5140	13552
chr13	74599858	74600983	1125	chr13	74617965	74620391	Zfp825	-	2426	16982
chr13	74659615	74660994	1379	chr13	74617965	74620391	Zfp825	-	2426	39224
chr13	74754056	74755807	1751	chr13	74777320	74829983	Erap1	+	52663	21513
chr13	75503880	75506394	2514	chr13	75227274	75269946	Pcsk1	+	42672	233934
chr13	75925178	75929228	4050	chr13	75844932	75909804	Ell2	+	64872	15374
chr13	75934633	75936893	2260	chr13	75844932	75909804	Ell2	+	64872	24829
chr13	81079391	81081164	1773	chr13	81096926	81102991	Gm4211	-	6065	15762
chr13	83038297	83039482	1185	chr13	83643033	83806684	Mef2c	+	163651	603551
chr13	83044639	83045639	1000	chr13	83643033	83806684	Mef2c	+	163651	597394
chr13	83047804	83049480	1676	chr13	83643033	83806684	Mef2c	+	163651	593553
chr13	83053598	83055185	1587	chr13	83643033	83806684	Mef2c	+	163651	587848
chr13	83158444	83160900	2456	chr13	83643033	83806684	Mef2c	+	163651	482133
chr13	83179784	83180784	1000	chr13	83643033	83806684	Mef2c	+	163651	462249
chr13	83182515	83185975	3460	chr13	83643033	83806684	Mef2c	+	163651	457058
chr13	83194782	83195877	1095	chr13	83643033	83806684	Mef2c	+	163651	447156
chr13	83212693	83214913	2220	chr13	83643033	83806684	Mef2c	+	163651	428120
chr13	83249850	83252636	2786	chr13	83643033	83806684	Mef2c	+	163651	390397
chr13	83355807	83356807	1000	chr13	83643033	83806684	Mef2c	+	163651	286226
chr13	85568936	85571401	2465	chr13	85354304	85429091	Rasa1	-	74787	139845
chr13	85597858	85599803	1945	chr13	85354304	85429091	Rasa1	-	74787	168767
chr13	85638328	85639328	1000	chr13	85354304	85429091	Rasa1	-	74787	209237
chr13	85863592	85865230	1638	chr13	86184421	86186509	Cox7c	-	2088	319191
chr13	89567485	89568719	1234	chr13	88961077	89462828	Edil3	+	501751	104657
chr13	89592482	89595126	2644	chr13	89674476	89674580	AC154460.1	-	104	79350
chr13	91570037	91571106	1069	chr13	91599888	91843034	Ssbp2	+	243146	28782
chr13	91590935	91591965	1030	chr13	91599888	91843034	Ssbp2	+	243146	7923
chr13	93492168	93493168	1000	chr13	93381093	93481899	Serinc5	+	100806	10269
chr13	93732849	93735337	2488	chr13	93810668	93914679	Cmya5	-	104011	75331
chr13	94012295	94013415	1120	chr13	93917355	93962238	Papd4	-	44883	50057
chr13	96151515	96153297	1782	chr13	96120638	96145307	Aggf1	-	24669	6208
chr13	96362235	96363303	1068	chr13	96371759	96388414	F2r	-	16655	8456
chr13	97466785	97468785	2000	chr13	97418922	97440891	Hmgcr	-	21969	25894
chr13	97974958	97975958	1000	chr13	97946287	97968312	Hexb	-	22025	6646
chr13	98328108	98331715	3607	chr13	98204925	98266960	Gm11019	+	62035	61148
chr13	99601241	99603364	2123	chr13	99608974	99696339	Tnpo1	-	87365	5610
chr13	99706544	99708589	2045	chr13	99608974	99696339	Tnpo1	-	87365	10205
chr13	99737778	99738796	1018	chr13	99754045	99754520	1700024P04Rik	-	475	15249
chr13	99744865	99745921	1056	chr13	99754045	99754520	1700024P04Rik	-	475	8124
chr13	99942586	99945956	3370	chr13	99954778	100016992	Zfp366	+	62214	8822
chr13	100708256	100709723	1467	chr13	100718488	100785594	Mccc2	-	67106	8765
chr13	101358224	101359311	1087	chr13	101365912	101386926	Marveld2	-	21014	6601
chr13	101519634	101521715	2081	chr13	101505910	101514614	Mrps36	-	8704	5020
chr13	101635363	101636632	1269	chr13	101572604	101603382	Slc30a5	-	30778	31981
chr13	102309735	102311322	1587	chr13	102450716	102538172	Pik3r1	-	87456	139394
chr13	102338565	102340367	1802	chr13	102450716	102538172	Pik3r1	-	87456	110349
chr13	102410798	102413005	2207	chr13	102450716	102538172	Pik3r1	-	87456	37711
chr13	102424755	102429521	4766	chr13	102450716	102538172	Pik3r1	-	87456	21195
chr13	102432042	102434888	2846	chr13	102450716	102538172	Pik3r1	-	87456	15828
chr13	102437229	102440112	2883	chr13	102450716	102538172	Pik3r1	-	87456	10604
chr13	102571047	102572186	1139	chr13	102450716	102538172	Pik3r1	-	87456	32875
chr13	102636139	102637714	1575	chr13	102450716	102538172	Pik3r1	-	87456	97967
chr13	103455173	103456872	1699	chr13	103483638	103529709	Cd180	+	46071	26766
chr13	103468952	103474439	5487	chr13	103483638	103529709	Cd180	+	46071	9199
chr13	105395999	105397989	1990	chr13	105421220	105607222	Cwc27	-	186002	23231
chr13	105399729	105401814	2085	chr13	105421220	105607222	Cwc27	-	186002	19406
chr13	105408035	105414130	6095	chr13	105421220	105607222	Cwc27	-	186002	7090
chr13	106089888	106090975	1087	chr13	105921444	106061119	Rnf180	-	139675	28769
chr13	108358235	108364842	6607	chr13	108514698	108680258	Zswim6	-	165560	149856
chr13	109087170	109088170	1000	chr13	109004598	109077299	Elovl7	+	72701	9871
chr13	111354040	111355040	1000	chr13	111185252	111191052	Plk2	+	5800	162988
chr13	111750375	111751769	1394	chr13	111674450	111674543	CT010480.1	+	93	75832
chr13	111757294	111762107	4813	chr13	111674450	111674543	CT010480.1	+	93	82751
chr13	112609694	112611169	1475	chr13	112599349	112601247	Gm15327	+	1898	8447
chr13	112611246	112613766	2520	chr13	112599349	112601247	Gm15327	+	1898	9999
chr13	112682406	112684270	1864	chr13	112672601	112674385	Gm9025	-	1784	8021
chr13	112710026	112712712	2686	chr13	112672601	112674385	Gm9025	-	1784	35641
chr13	112719378	112721084	1706	chr13	112672601	112674385	Gm9025	-	1784	44993
chr13	112735361	112737650	2289	chr13	112781674	112785694	Gm15322	+	4020	44024
chr13	112767857	112772068	4211	chr13	112781674	112785694	Gm15322	+	4020	9606
chr13	112772163	112775436	3273	chr13	112781674	112785694	Gm15322	+	4020	6238
chr13	113179853	113181579	1726	chr13	113078659	113174210	Ankrd55	+	95551	5643
chr13	113214350	113215901	1551	chr13	113078659	113174210	Ankrd55	+	95551	40140
chr13	113216220	113218630	2410	chr13	113078659	113174210	Ankrd55	+	95551	42010
chr13	113222740	113224397	1657	chr13	113265216	113297068	Il6st	+	31852	40819
chr13	113228052	113230302	2250	chr13	113265216	113297068	Il6st	+	31852	34914
chr13	113232739	113234519	1780	chr13	113265216	113297068	Il6st	+	31852	30697
chr13	113236804	113237977	1173	chr13	113265216	113297068	Il6st	+	31852	27239
chr13	113253398	113255004	1606	chr13	113265216	113297068	Il6st	+	31852	10212
chr13	113541576	113542826	1250	chr13	113523861	113525267	Slc38a9	+	1406	16309
chr13	113550057	113551616	1559	chr13	113523861	113525267	Slc38a9	+	1406	24790
chr13	113801909	113804838	2929	chr13	113784076	113790602	Gm6320	+	6526	11307
chr13	114060840	114061966	1126	chr13	113961816	114016116	Gzmk	-	54300	44724
chr13	114426024	114427024	1000	chr13	114382388	114408772	Snx18	-	26384	17252
chr13	117821411	117823458	2047	chr13	117643631	117814323	Parp8	-	170692	7088
chr13	117915458	117917576	2118	chr13	118007508	118009882	Gm17509	-	2374	89932
chr13	117920347	117922260	1913	chr13	118007508	118009882	Gm17509	-	2374	85248
chr13	117982203	117983203	1000	chr13	118007508	118009882	Gm17509	-	2374	24305
chr13	117984330	117988546	4216	chr13	118007508	118009882	Gm17509	-	2374	18962
chr13	117999570	118001082	1512	chr13	118007508	118009882	Gm17509	-	2374	6426
chr13	118077961	118078961	1000	chr13	118009432	118062905	Emb	+	53473	15056
chr13	3748918	3749918	1000	chr13	3802139	3803564	Calml3	-	1425	52221
chr13	5511135	5512135	1000	chr13	5189049	5189180	SNORA17	-	131	321955
chr13	5802784	5804027	1243	chr13	5860735	5869639	Klf6	+	8904	56708
chr13	5979165	5980368	1203	chr13	5996701	5996797	AC154816.1	-	96	16333
chr13	9897228	9898228	1000	chr13	9876381	9878329	Chrm3	-	1948	18899
chr13	13981698	13982698	1000	chr13	13876326	13920164	Gng4	+	43838	61534
chr13	16557071	16558708	1637	chr13	16930969	16931094	AC154368.1	-	125	372261
chr13	21252415	21253415	1000	chr13	21233895	21234950	Olfr1368	-	1055	17465
chr13	21947107	21948186	1079	chr13	21925612	21929399	Hist1h2br	+	3787	17708
chr13	22066170	22067199	1029	chr13	22073063	22080603	Pom121l2	+	7540	5864
chr13	24607007	24608055	1048	chr13	24578531	24578633	U6	-	102	28374
chr13	30816178	30817862	1684	chr13	30823646	30823905	Gm11370	+	259	5784
chr13	30869578	30870578	1000	chr13	30841095	30858796	Irf4	+	17701	10782
chr13	31077568	31078568	1000	chr13	31066073	31067845	Gm5447	+	1772	9723
chr13	34246083	34247083	1000	chr13	34254833	34270041	Psmg4	+	15208	7750
chr13	37223277	37224277	1000	chr13	36959047	37142113	F13a1	-	183066	81164
chr13	37525864	37526956	1092	chr13	37437214	37510905	Ly86	+	73691	14959
chr13	37702495	37704427	1932	chr13	37870269	38043871	Rreb1	+	173602	165842
chr13	41600332	41601987	1655	chr13	41405285	41582689	Nedd9	-	177404	17643
chr13	41641392	41642831	1439	chr13	41673278	41673443	AC154848.1	-	165	30447
chr13	43847899	43848899	1000	chr13	43880476	43898499	Cd83	+	18023	31577
chr13	43860916	43861916	1000	chr13	43880476	43898499	Cd83	+	18023	18560
chr13	43873131	43874131	1000	chr13	43880476	43898499	Cd83	+	18023	6345
chr13	44512877	44513877	1000	chr13	44216536	44220548	Gm5083	+	4012	292329
chr13	44597360	44598360	1000	chr13	44824843	45017012	Jarid2	+	192169	226483
chr13	44602510	44604316	1806	chr13	44824843	45017012	Jarid2	+	192169	220527
chr13	44635935	44636938	1003	chr13	44824843	45017012	Jarid2	+	192169	187905
chr13	44677070	44678417	1347	chr13	44824843	45017012	Jarid2	+	192169	146426
chr13	44768925	44769925	1000	chr13	44824843	45017012	Jarid2	+	192169	54918
chr13	44815415	44816547	1132	chr13	44824843	45017012	Jarid2	+	192169	8296
chr13	45564318	45565472	1154	chr13	45581593	45581699	U6	-	106	16121
chr13	46830917	46832282	1365	chr13	46775271	46823218	Nup153	-	47947	7699
chr13	48641118	48642822	1704	chr13	48633548	48633641	Mirlet7a-1	-	93	7477
chr13	51166426	51167946	1520	chr13	51196267	51247915	Spin1	+	51648	28321
chr13	51369832	51370970	1138	chr13	51298057	51298434	Hist1h2al	-	377	71398
chr13	51380061	51381061	1000	chr13	51298057	51298434	Hist1h2al	-	377	81627
chr13	51486686	51487750	1064	chr13	51503987	51518166	S1pr3	+	14179	16237
chr13	51495398	51497418	2020	chr13	51503987	51518166	S1pr3	+	14179	6569
chr13	52137368	52138368	1000	chr13	52068583	52071952	Gm16767	+	3369	65416
chr13	52210269	52211269	1000	chr13	52068583	52071952	Gm16767	+	3369	138317
chr13	52263427	52265031	1604	chr13	52068583	52071952	Gm16767	+	3369	191475
chr13	52646257	52647487	1230	chr13	52599744	52626205	Diras2	-	26461	20052
chr13	52888265	52890156	1891	chr13	52930488	53025050	Auh	-	94562	40332
chr13	52913474	52915107	1633	chr13	52930488	53025050	Auh	-	94562	15381
chr13	54397967	54399145	1178	chr13	54472713	54485278	Cplx2	+	12565	73568
chr13	63894015	63895015	1000	chr13	63916548	64001610	0610007P08Rik	+	85062	21533
chr13	63895294	63896321	1027	chr13	63916548	64001610	0610007P08Rik	+	85062	20227
chr13	63909240	63910240	1000	chr13	63916548	64001610	0610007P08Rik	+	85062	6308
chr13	65341882	65342959	1077	chr13	65360847	65362134	Gm10775	+	1287	17888
chr13	71467141	71468141	1000	chr13	71245967	71246087	Mir466f-4	+	120	221054
chr13	73596480	73597480	1000	chr13	73604645	73653870	Lpcat1	+	49225	7165
chr13	74631204	74632320	1116	chr13	74617965	74620391	Zfp825	-	2426	10813
chr13	74701178	74702366	1188	chr13	74777320	74829983	Erap1	+	52663	74954
chr13	83049565	83051305	1740	chr13	83643033	83806684	Mef2c	+	163651	591728
chr13	83180962	83182435	1473	chr13	83643033	83806684	Mef2c	+	163651	460598
chr13	83204456	83206432	1976	chr13	83643033	83806684	Mef2c	+	163651	436601
chr13	83208263	83212483	4220	chr13	83643033	83806684	Mef2c	+	163651	430550
chr13	85498735	85499797	1062	chr13	85354304	85429091	Rasa1	-	74787	69644
chr13	85646585	85647703	1118	chr13	85354304	85429091	Rasa1	-	74787	217494
chr13	89660403	89662923	2520	chr13	89674476	89674580	AC154460.1	-	104	11553
chr13	94759185	94760760	1575	chr13	94726265	94726364	U6	+	99	32821
chr13	96188794	96190416	1622	chr13	96201326	96214786	Crhbp	-	13460	10910
chr13	96264668	96266649	1981	chr13	96281687	96295195	F2rl1	-	13508	15038
chr13	96363364	96364364	1000	chr13	96371759	96388414	F2r	-	16655	7395
chr13	99449461	99450705	1244	chr13	99456190	99464789	Tmem171	-	8599	5485
chr13	99714441	99716618	2177	chr13	99608974	99696339	Tnpo1	-	87365	18102
chr13	106083926	106084996	1070	chr13	105921444	106061119	Rnf180	-	139675	22807
chr13	107884531	107886908	2377	chr13	107822043	107823753	3830408C21Rik	+	1710	60778
chr13	107891022	107892151	1129	chr13	107822043	107823753	3830408C21Rik	+	1710	67269
chr13	108693446	108694446	1000	chr13	108514698	108680258	Zswim6	-	165560	13188
chr13	112726386	112727452	1066	chr13	112672601	112674385	Gm9025	-	1784	52001
chr13	113187472	113189987	2515	chr13	113078659	113174210	Ankrd55	+	95551	13262
chr13	117820378	117821378	1000	chr13	117643631	117814323	Parp8	-	170692	6055
chr14	9104942	9106040	1098	chr14	9058025	9091867	Acox2	-	33842	13075
chr14	14813729	14814729	1000	chr14	14781528	14793739	Thoc7	-	12211	19990
chr14	15126677	15127711	1034	chr14	15160627	15161580	Olfr31	+	953	32916
chr14	15357553	15358970	1417	chr14	15239729	15240679	Olfr721-ps1	+	950	116874
chr14	15500785	15503128	2343	chr14	15535539	15632457	Slc4a7	+	96918	32411
chr14	15505237	15506237	1000	chr14	15535539	15632457	Slc4a7	+	96918	29302
chr14	15506643	15508529	1886	chr14	15535539	15632457	Slc4a7	+	96918	27010
chr14	15516541	15520621	4080	chr14	15535539	15632457	Slc4a7	+	96918	14918
chr14	16578718	16579718	1000	chr14	16270137	16284937	Gm17628	+	14800	293781
chr14	16601853	16603284	1431	chr14	16270137	16284937	Gm17628	+	14800	316916
chr14	16766398	16768281	1883	chr14	17071170	17082322	Oxsm	-	11152	302889
chr14	17003884	17007806	3922	chr14	17071170	17082322	Oxsm	-	11152	63364
chr14	18243217	18244397	1180	chr14	18493474	18870602	Thrb	+	377128	249077
chr14	18308008	18309008	1000	chr14	18493474	18870602	Thrb	+	377128	184466
chr14	20658420	20659530	1110	chr14	20630624	20643045	2700060E02Rik	-	12421	15375
chr14	20676355	20678042	1687	chr14	20691781	20796849	Gng2	-	105068	13739
chr14	20803648	20804706	1058	chr14	20691781	20796849	Gng2	-	105068	6799
chr14	20843879	20845073	1194	chr14	20691781	20796849	Gng2	-	105068	47030
chr14	21458607	21459607	1000	chr14	21468324	21475762	Myoz1	-	7438	8717
chr14	21647985	21649744	1759	chr14	21655884	21662610	Plau	+	6726	6140
chr14	22624473	22626766	2293	chr14	22631933	22632077	U12	+	144	5167
chr14	25539354	25541613	2259	chr14	25441360	25448422	4930428N03Rik	+	7062	90932
chr14	25598217	25600206	1989	chr14	25728900	25732926	Gm10398	+	4026	128694
chr14	25603376	25605279	1903	chr14	25728900	25732926	Gm10398	+	4026	123621
chr14	25619185	25625251	6066	chr14	25728900	25732926	Gm10398	+	4026	103649
chr14	26208196	26209196	1000	chr14	26175287	26198121	Gm17716	-	22834	10075
chr14	26211922	26213160	1238	chr14	26175287	26198121	Gm17716	-	22834	13801
chr14	26225328	26227474	2146	chr14	26175287	26198121	Gm17716	-	22834	27207
chr14	26599264	26601294	2030	chr14	26531126	26588342	Zcchc24	-	57216	10922
chr14	27390962	27392792	1830	chr14	27399064	27452880	Fam116a	+	53816	6272
chr14	27806256	27808358	2102	chr14	27813548	27815515	Hesx1	+	1967	5190
chr14	27927425	27928425	1000	chr14	27852187	27920472	Il17rd	+	68285	6953
chr14	27935760	27936760	1000	chr14	27852187	27920472	Il17rd	+	68285	15288
chr14	28225245	28226245	1000	chr14	28051225	28217090	Arhgef3	+	165865	8155
chr14	28375229	28376735	1506	chr14	28340937	28341034	SNORA67	-	97	34195
chr14	31447751	31449380	1629	chr14	31408542	31439396	Prkcd	-	30854	8355
chr14	31454262	31456039	1777	chr14	31467546	31504503	Rft1	+	36957	11507
chr14	31456754	31457754	1000	chr14	31467546	31504503	Rft1	+	36957	9792
chr14	32256084	32258181	2097	chr14	32173066	32249264	Sh3bp5	-	76198	6820
chr14	32258457	32263019	4562	chr14	32173066	32249264	Sh3bp5	-	76198	9193
chr14	32266434	32268147	1713	chr14	32173066	32249264	Sh3bp5	-	76198	17170
chr14	32497394	32500085	2691	chr14	32513201	32643601	Ankrd28	-	130400	13116
chr14	33496052	33497408	1356	chr14	33472954	33477192	3425401B19Rik	-	4238	18860
chr14	33509499	33510661	1162	chr14	33472954	33477192	3425401B19Rik	-	4238	32307
chr14	34005963	34008567	2604	chr14	33772733	33998694	Wdfy4	-	225961	7269
chr14	37676727	37677813	1086	chr14	37669115	37669230	n-R5s46	-	115	7497
chr14	37681048	37682577	1529	chr14	37688122	37781950	Gcap14	-	93828	5545
chr14	45653268	45655293	2025	chr14	45591943	45626575	Gm17173	-	34632	26693
chr14	45656301	45659625	3324	chr14	45591943	45626575	Gm17173	-	34632	29726
chr14	45659937	45661083	1146	chr14	45591943	45626575	Gm17173	-	34632	33362
chr14	45668829	45670398	1569	chr14	45591943	45626575	Gm17173	-	34632	42254
chr14	45698871	45699871	1000	chr14	45754123	45840003	Txndc16	-	85880	54252
chr14	45710669	45712950	2281	chr14	45754123	45840003	Txndc16	-	85880	41173
chr14	45721046	45723585	2539	chr14	45754123	45840003	Txndc16	-	85880	30538
chr14	45726758	45729180	2422	chr14	45754123	45840003	Txndc16	-	85880	24943
chr14	46304275	46306738	2463	chr14	46286298	46288173	A530076I17Rik	-	1875	16102
chr14	47969827	47971176	1349	chr14	47987426	48005835	Lgals3	+	18409	16250
chr14	47978502	47980956	2454	chr14	47987426	48005835	Lgals3	+	18409	6470
chr14	48217575	48218575	1000	chr14	48189117	48189452	Gm6616	+	335	28123
chr14	48237972	48239595	1623	chr14	48283431	48356238	Ktn1	+	72807	43836
chr14	48244467	48246756	2289	chr14	48283431	48356238	Ktn1	+	72807	36675
chr14	48267502	48269935	2433	chr14	48283431	48356238	Ktn1	+	72807	13496
chr14	48273707	48275119	1412	chr14	48283431	48356238	Ktn1	+	72807	8312
chr14	51595857	51597073	1216	chr14	51575667	51584424	Pnp2	+	8757	11433
chr14	51600315	51602050	1735	chr14	51575667	51584424	Pnp2	+	8757	15891
chr14	51610208	51611901	1693	chr14	51627426	51630433	Rnase10	+	3007	15525
chr14	51616329	51617374	1045	chr14	51627426	51630433	Rnase10	+	3007	10052
chr14	52669965	52671581	1616	chr14	52654757	52655818	Olfr221	-	1061	14147
chr14	52863433	52864990	1557	chr14	52817826	52857466	Chd8	-	39640	5967
chr14	53320599	53321599	1000	chr14	53330588	53331100	Trav4d-2	+	512	8989
chr14	54970603	54972240	1637	chr14	54980525	54989353	Oxa1l	+	8828	8285
chr14	55110899	55113268	2369	chr14	55094937	55099271	Rem2	+	4334	11628
chr14	55765044	55766878	1834	chr14	55780314	55780445	SNORA17	-	131	13436
chr14	57448853	57450864	2011	chr14	57455908	57455993	SNORD86	-	85	5044
chr14	58387850	58388850	1000	chr14	58260914	58377225	Lats2	-	116311	10625
chr14	58390399	58392502	2103	chr14	58260914	58377225	Lats2	-	116311	13174
chr14	59181163	59182901	1738	chr14	59269105	59269237	SNORA17	-	132	86204
chr14	61061910	61064566	2656	chr14	60997084	60999840	Fam123a	+	2756	62070
chr14	62307501	62309391	1890	chr14	62238318	62301162	Dleu2	-	62844	6339
chr14	62387862	62388862	1000	chr14	62371057	62371175	Mir1196	-	118	16687
chr14	62589394	62591184	1790	chr14	62371057	62371175	Mir1196	-	118	218219
chr14	62640505	62643203	2698	chr14	62895068	62911800	Dleu7	-	16732	251865
chr14	64045428	64047707	2279	chr14	64055231	64084335	Fam167a	+	29104	7524
chr14	65767979	65769072	1093	chr14	65728825	65729084	AC124489.1	-	259	38895
chr14	65948717	65949717	1000	chr14	65885538	65942808	Fbxo16	+	57270	5909
chr14	65949841	65950841	1000	chr14	65885538	65942808	Fbxo16	+	57270	7033
chr14	65961852	65963608	1756	chr14	65977513	66017767	Zfp395	+	40254	13905
chr14	65970084	65972128	2044	chr14	65977513	66017767	Zfp395	+	40254	5385
chr14	67806936	67808382	1446	chr14	67851274	67851966	RP23-177N16.1	-	692	42892
chr14	69753338	69754798	1460	chr14	69776911	69777576	Rps2-ps5	+	665	22113
chr14	69758456	69759456	1000	chr14	69776911	69777576	Rps2-ps5	+	665	17455
chr14	70223785	70225069	1284	chr14	70184797	70212310	Rhobtb2	-	27513	11475
chr14	70229590	70230829	1239	chr14	70240227	70459693	Pebp4	+	219466	9398
chr14	71195784	71199423	3639	chr14	71165843	71178302	Dok2	+	12459	17482
chr14	73177152	73179924	2772	chr14	72937753	73109810	Fndc3a	-	172057	67342
chr14	73262149	73263699	1550	chr14	72937753	73109810	Fndc3a	-	172057	152339
chr14	73263825	73265792	1967	chr14	72937753	73109810	Fndc3a	-	172057	154015
chr14	73268440	73270115	1675	chr14	72937753	73109810	Fndc3a	-	172057	158630
chr14	73276138	73279150	3012	chr14	73428935	73448921	Cysltr2	-	19986	149785
chr14	73286071	73288077	2006	chr14	73428935	73448921	Cysltr2	-	19986	140858
chr14	73332266	73334626	2360	chr14	73428935	73448921	Cysltr2	-	19986	94309
chr14	73382421	73383804	1383	chr14	73428935	73448921	Cysltr2	-	19986	45131
chr14	73456073	73459509	3436	chr14	73428935	73448921	Cysltr2	-	19986	7152
chr14	73732275	73734769	2494	chr14	73583480	73725629	Rb1	-	142149	6646
chr14	73739176	73741285	2109	chr14	73583480	73725629	Rb1	-	142149	13547
chr14	73833027	73834127	1100	chr14	73762038	73785078	Itm2b	-	23040	47949
chr14	73840659	73843144	2485	chr14	73762038	73785078	Itm2b	-	23040	55581
chr14	73844325	73846230	1905	chr14	73762038	73785078	Itm2b	-	23040	59247
chr14	74301693	74303187	1494	chr14	74345340	74345445	5S_rRNA	-	105	42153
chr14	75376396	75377396	1000	chr14	75154480	75347684	Lrch1	-	193204	28712
chr14	75395745	75397350	1605	chr14	75415834	75452339	5031414D18Rik	+	36505	18484
chr14	75405135	75407182	2047	chr14	75415834	75452339	5031414D18Rik	+	36505	8652
chr14	75459793	75460875	1082	chr14	75415834	75452339	5031414D18Rik	+	36505	7454
chr14	75468138	75469711	1573	chr14	75484110	75530690	Lrrc63	-	46580	14399
chr14	76551708	76553599	1891	chr14	76510698	76537186	Nufip1	+	26488	14522
chr14	77072687	77074819	2132	chr14	76932621	76956665	Serp2	-	24044	116022
chr14	77086143	77088817	2674	chr14	76932621	76956665	Serp2	-	24044	129478
chr14	77160099	77161195	1096	chr14	76932621	76956665	Serp2	-	24044	203434
chr14	77163823	77165614	1791	chr14	76932621	76956665	Serp2	-	24044	207158
chr14	77250942	77252037	1095	chr14	77424007	77436711	9030625A04Rik	-	12704	171970
chr14	77302476	77304274	1798	chr14	77424007	77436711	9030625A04Rik	-	12704	119733
chr14	78438064	78441400	3336	chr14	78470524	78490593	Gm19301	+	20069	29124
chr14	78718750	78719754	1004	chr14	78711033	78711147	AC126690.2	-	114	7603
chr14	78729860	78730860	1000	chr14	78711033	78711147	AC126690.2	-	114	18713
chr14	78755850	78757761	1911	chr14	78711033	78711147	AC126690.2	-	114	44703
chr14	78809714	78810714	1000	chr14	78892053	78936667	Akap11	-	44614	81339
chr14	78831228	78832518	1290	chr14	78892053	78936667	Akap11	-	44614	59535
chr14	78834807	78836252	1445	chr14	78892053	78936667	Akap11	-	44614	55801
chr14	79131440	79133370	1930	chr14	78969416	79124896	Dgkh	-	155480	6544
chr14	79147762	79149540	1778	chr14	78969416	79124896	Dgkh	-	155480	22866
chr14	79667083	79669068	1985	chr14	79688563	79701452	1190002H23Rik	-	12889	19495
chr14	79669349	79670349	1000	chr14	79688563	79701452	1190002H23Rik	-	12889	18214
chr14	83343452	83344452	1000	chr14	82897016	82897084	snR78	-	68	446368
chr14	94937685	94944495	6810	chr14	94847440	94847570	SNORA17	-	130	90115
chr14	100682861	100685636	2775	chr14	100612361	100645499	4930517O19Rik	+	33138	37362
chr14	100858886	100861877	2991	chr14	100817702	100817833	SNORA17	+	131	41053
chr14	102102272	102105429	3157	chr14	102053184	102095341	Uchl3	+	42157	6931
chr14	102105596	102106598	1002	chr14	102053184	102095341	Uchl3	+	42157	10255
chr14	103266454	103267869	1415	chr14	103205316	103205363	5S_rRNA	+	47	61091
chr14	103305331	103308750	3419	chr14	103377437	103381745	Kctd12	-	4308	68687
chr14	103323321	103325615	2294	chr14	103377437	103381745	Kctd12	-	4308	51822
chr14	103325932	103328171	2239	chr14	103377437	103381745	Kctd12	-	4308	49266
chr14	103341429	103342915	1486	chr14	103377437	103381745	Kctd12	-	4308	34522
chr14	103432097	103433622	1525	chr14	103446194	103455790	Irg1	+	9596	12572
chr14	103434551	103439111	4560	chr14	103446194	103455790	Irg1	+	9596	7083
chr14	103762093	103763524	1431	chr14	103512628	103746031	Mycbp2	-	233403	16062
chr14	103868468	103869531	1063	chr14	103912558	104012563	Scel	+	100005	43027
chr14	103874192	103875192	1000	chr14	103912558	104012563	Scel	+	100005	37366
chr14	103875935	103877759	1824	chr14	103912558	104012563	Scel	+	100005	34799
chr14	103885554	103888432	2878	chr14	103912558	104012563	Scel	+	100005	24126
chr14	104018097	104019490	1393	chr14	103912558	104012563	Scel	+	100005	5534
chr14	104019506	104021844	2338	chr14	103912558	104012563	Scel	+	100005	6943
chr14	105727325	105728325	1000	chr14	105657928	105708515	Ndfip2	+	50587	18810
chr14	105881622	105883216	1594	chr14	105898005	105904839	4930449E01Rik	+	6834	14789
chr14	106182089	106183246	1157	chr14	106216125	106216217	AC140340.1	+	92	32879
chr14	106321529	106323141	1612	chr14	106291166	106296036	Spry2	-	4870	25493
chr14	106425185	106427200	2015	chr14	106492367	106493050	Gm6219	-	683	65167
chr14	106433579	106435064	1485	chr14	106492367	106493050	Gm6219	-	683	57303
chr14	109063500	109065281	1781	chr14	109091411	109091860	Rpl27a-ps2	-	449	26130
chr14	109102335	109104991	2656	chr14	109091411	109091860	Rpl27a-ps2	-	449	10475
chr14	115347444	115348708	1264	chr14	115379650	115379755	U6	-	105	30942
chr14	115416665	115417824	1159	chr14	115442101	115445949	Mir17hg	+	3848	24277
chr14	120851804	120853870	2066	chr14	120674891	120830919	Mbnl2	+	156028	20885
chr14	122229058	122230058	1000	chr14	121941261	122196956	Dock9	-	255695	32102
chr14	122265752	122266752	1000	chr14	122277828	122420256	Ubac2	+	142428	11076
chr14	122451407	122452407	1000	chr14	122433896	122437642	Timm8a2	+	3746	13765
chr14	122456246	122457246	1000	chr14	122433896	122437642	Timm8a2	+	3746	18604
chr14	122462156	122463156	1000	chr14	122433896	122437642	Timm8a2	+	3746	24514
chr14	122463291	122464744	1453	chr14	122433896	122437642	Timm8a2	+	3746	25649
chr14	122464899	122466077	1178	chr14	122433896	122437642	Timm8a2	+	3746	27257
chr14	122471695	122473740	2045	chr14	122502652	122506196	A330035P11Rik	-	3544	28912
chr14	15465702	15466782	1080	chr14	15535539	15632457	Slc4a7	+	96918	68757
chr14	15514160	15515160	1000	chr14	15535539	15632457	Slc4a7	+	96918	20379
chr14	16617315	16618315	1000	chr14	16270137	16284937	Gm17628	+	14800	332378
chr14	20804719	20806228	1509	chr14	20691781	20796849	Gng2	-	105068	7870
chr14	20812404	20813760	1356	chr14	20691781	20796849	Gng2	-	105068	15555
chr14	21459898	21460997	1099	chr14	21468324	21475762	Myoz1	-	7438	7327
chr14	21643982	21644982	1000	chr14	21655884	21662610	Plau	+	6726	10902
chr14	21704488	21705546	1058	chr14	21675233	21675643	Gm6128	-	410	28845
chr14	27383706	27385695	1989	chr14	27399064	27452880	Fam116a	+	53816	13369
chr14	27498488	27499488	1000	chr14	27483603	27489332	Pde12	-	5729	9156
chr14	28042692	28045377	2685	chr14	28051225	28217090	Arhgef3	+	165865	5848
chr14	37129824	37131475	1651	chr14	36908145	36911467	4930474N05Rik	+	3322	218357
chr14	50681474	50682474	1000	chr14	50703389	50704354	Olfr726	-	965	20915
chr14	51590458	51591458	1000	chr14	51575667	51584424	Pnp2	+	8757	6034
chr14	51702553	51703599	1046	chr14	51710752	51725826	Rnase4	+	15074	7153
chr14	51857485	51858485	1000	chr14	51874941	51875787	Ear11	-	846	16456
chr14	51885282	51886282	1000	chr14	51874941	51875787	Ear11	-	846	9495
chr14	53167763	53168763	1000	chr14	53186968	53187726	Trav2	+	758	18205
chr14	54917273	54918273	1000	chr14	54901571	54902600	Olfr49	-	1029	14673
chr14	55812350	55813620	1270	chr14	55840844	55860272	Dhrs2	+	19428	27224
chr14	61946214	61947699	1485	chr14	61958600	61979282	Ebpl	-	20682	10901
chr14	62114133	62115133	1000	chr14	62085805	62086203	Rps12-ps2	-	398	27930
chr14	62355367	62356685	1318	chr14	62371057	62371175	Mir1196	-	118	14372
chr14	62389023	62390023	1000	chr14	62371057	62371175	Mir1196	-	118	17848
chr14	69536790	69537790	1000	chr14	69647295	69659861	Stc1	+	12566	109505
chr14	70466003	70467003	1000	chr14	70240227	70459693	Pebp4	+	219466	6310
chr14	73207236	73209406	2170	chr14	72937753	73109810	Fndc3a	-	172057	97426
chr14	73221279	73222367	1088	chr14	72937753	73109810	Fndc3a	-	172057	111469
chr14	73735279	73737256	1977	chr14	73583480	73725629	Rb1	-	142149	9650
chr14	73800887	73802561	1674	chr14	73762038	73785078	Itm2b	-	23040	15809
chr14	75389386	75390386	1000	chr14	75415834	75452339	5031414D18Rik	+	36505	25448
chr14	75844632	75846445	1813	chr14	75855789	75925948	Siah3	+	70159	9344
chr14	76228551	76229752	1201	chr14	76243186	76244771	Gm4285	-	1585	13434
chr14	76233895	76235010	1115	chr14	76243186	76244771	Gm4285	-	1585	8176
chr14	79198520	79199520	1000	chr14	79248985	79602117	1300010F03Rik	+	353132	49465
chr14	104117932	104119073	1141	chr14	104049445	104104124	Slain1	+	54679	13808
chr14	105581747	105582747	1000	chr14	105505968	105576544	Rbm26	-	70576	5203
chr14	106131633	106132633	1000	chr14	106081045	106081421	Gm10076	+	376	50212
chr14	118488036	118489145	1109	chr14	118507053	118516322	Gm16847	+	9269	17908
chr14	121230935	121233024	2089	chr14	121198075	121198158	U6	+	83	32777
chr14	122222219	122223409	1190	chr14	121941261	122196956	Dock9	-	255695	25263
chr14	122224071	122225071	1000	chr14	121941261	122196956	Dock9	-	255695	27115
chr14	122264390	122265711	1321	chr14	122277828	122420256	Ubac2	+	142428	12117
chr14	122452550	122453575	1025	chr14	122433896	122437642	Timm8a2	+	3746	14908
chr15	5211385	5214115	2730	chr15	5156661	5194187	Ptger4	-	37526	17198
chr15	5363816	5364818	1002	chr15	5156661	5194187	Ptger4	-	37526	169629
chr15	5364978	5366392	1414	chr15	5156661	5194187	Ptger4	-	37526	170791
chr15	5380000	5382439	2439	chr15	5156661	5194187	Ptger4	-	37526	185813
chr15	5395566	5396818	1252	chr15	5156661	5194187	Ptger4	-	37526	201379
chr15	5424774	5427656	2882	chr15	5156661	5194187	Ptger4	-	37526	230587
chr15	5444791	5445791	1000	chr15	5156661	5194187	Ptger4	-	37526	250604
chr15	5461632	5463793	2161	chr15	5156661	5194187	Ptger4	-	37526	267445
chr15	5466997	5468143	1146	chr15	5156661	5194187	Ptger4	-	37526	272810
chr15	5484625	5486774	2149	chr15	5156661	5194187	Ptger4	-	37526	290438
chr15	5556940	5558560	1620	chr15	5156661	5194187	Ptger4	-	37526	362753
chr15	5574813	5575999	1186	chr15	5156661	5194187	Ptger4	-	37526	380626
chr15	6518081	6520649	2568	chr15	6529871	6613321	Fyb	+	83450	9222
chr15	7034336	7036106	1770	chr15	7079559	7147489	Lifr	+	67930	43453
chr15	7038201	7040869	2668	chr15	7079559	7147489	Lifr	+	67930	38690
chr15	7062925	7065443	2518	chr15	7079559	7147489	Lifr	+	67930	14116
chr15	8229111	8231209	2098	chr15	8119106	8221158	2410089E03Rik	+	102052	7953
chr15	8400959	8401973	1014	chr15	8241225	8394463	Nipbl	-	153238	6496
chr15	8461581	8462581	1000	chr15	8479135	8479434	Gm2348	-	299	16554
chr15	8539179	8540179	1000	chr15	8584124	8660764	Slc1a3	-	76640	43945
chr15	8575244	8576244	1000	chr15	8584124	8660764	Slc1a3	-	76640	7880
chr15	9421127	9422127	1000	chr15	9435916	9459631	Il7r	-	23715	13789
chr15	9501195	9502195	1000	chr15	9507948	9678623	Spef2	-	170675	5753
chr15	9702013	9705593	3580	chr15	9507948	9678623	Spef2	-	170675	23390
chr15	9791425	9792425	1000	chr15	9507948	9678623	Spef2	-	170675	112802
chr15	9799003	9801950	2947	chr15	9507948	9678623	Spef2	-	170675	120380
chr15	9937489	9938638	1149	chr15	9981581	9981868	7SK	+	287	42943
chr15	10002076	10005741	3665	chr15	9981581	9981868	7SK	+	287	20208
chr15	10805432	10807013	1581	chr15	10882087	10909905	C1qtnf3	+	27818	75074
chr15	11462163	11463802	1639	chr15	11313418	11329413	Tars	-	15995	132750
chr15	11463858	11464858	1000	chr15	11313418	11329413	Tars	-	15995	134445
chr15	11936636	11938079	1443	chr15	11911094	11926738	Sub1	-	15644	9898
chr15	11943027	11944899	1872	chr15	11911094	11926738	Sub1	-	15644	16289
chr15	11952009	11954054	2045	chr15	11911094	11926738	Sub1	-	15644	25271
chr15	11954808	11958091	3283	chr15	11911094	11926738	Sub1	-	15644	28070
chr15	11963538	11965793	2255	chr15	11911094	11926738	Sub1	-	15644	36800
chr15	11966188	11967288	1100	chr15	11911094	11926738	Sub1	-	15644	39450
chr15	11968491	11970627	2136	chr15	11911094	11926738	Sub1	-	15644	41753
chr15	12718546	12719546	1000	chr15	12737932	12754412	6030458C11Rik	-	16480	18386
chr15	25198541	25199749	1208	chr15	25293040	25343519	Basp1	-	50479	93291
chr15	27566732	27567983	1251	chr15	27535674	27560448	Fam105b	-	24774	6284
chr15	27570352	27571472	1120	chr15	27535674	27560448	Fam105b	-	24774	9904
chr15	27571873	27572873	1000	chr15	27535674	27560448	Fam105b	-	24774	11425
chr15	27653669	27655084	1415	chr15	27660407	27955603	Trio	-	295196	5323
chr15	28000149	28001384	1235	chr15	27660407	27955603	Trio	-	295196	44546
chr15	28009365	28011911	2546	chr15	27660407	27955603	Trio	-	295196	53762
chr15	28119352	28120403	1051	chr15	28133507	28401800	Dnahc5	+	268293	13104
chr15	31347240	31348960	1720	chr15	31370965	31383444	Ropn1l	-	12479	22005
chr15	31949743	31950942	1199	chr15	32107044	32108051	Tas2r119	+	1007	156102
chr15	33977456	33980062	2606	chr15	34012449	34072141	Mtdh	+	59692	32387
chr15	33996252	33997373	1121	chr15	34012449	34072141	Mtdh	+	59692	15076
chr15	34000045	34001198	1153	chr15	34012449	34072141	Mtdh	+	59692	11251
chr15	36377941	36378941	1000	chr15	36407423	36426546	Ankrd46	-	19123	28482
chr15	36507742	36508817	1075	chr15	36525416	36538728	Pabpc1	-	13312	16599
chr15	36558066	36559066	1000	chr15	36525416	36538728	Pabpc1	-	13312	19338
chr15	36577965	36580437	2472	chr15	36525416	36538728	Pabpc1	-	13312	39237
chr15	36617203	36618482	1279	chr15	36525416	36538728	Pabpc1	-	13312	78475
chr15	36645184	36646827	1643	chr15	36700525	36724302	Ywhaz	-	23777	53698
chr15	36687676	36690346	2670	chr15	36700525	36724302	Ywhaz	-	23777	10179
chr15	36768730	36769942	1212	chr15	36800256	36809571	Gm10384	-	9315	30314
chr15	36860651	36861709	1058	chr15	36800256	36809571	Gm10384	-	9315	51080
chr15	36862448	36865129	2681	chr15	36800256	36809571	Gm10384	-	9315	52877
chr15	36895685	36897187	1502	chr15	36926786	36937157	Zfp706	-	10371	29599
chr15	36908801	36910825	2024	chr15	36926786	36937157	Zfp706	-	10371	15961
chr15	36916674	36918886	2212	chr15	36926786	36937157	Zfp706	-	10371	7900
chr15	37010726	37012023	1297	chr15	36937278	36973855	Gm16631	+	36577	36871
chr15	37064949	37066021	1072	chr15	36937278	36973855	Gm16631	+	36577	91094
chr15	38058281	38060464	2183	chr15	37897083	38008608	Ubr5	-	111525	49673
chr15	38126247	38128165	1918	chr15	38148958	38156490	Odf1	+	7532	20793
chr15	38128366	38130880	2514	chr15	38148958	38156490	Odf1	+	7532	18078
chr15	38399604	38400637	1033	chr15	38417185	38449021	Azin1	-	31836	16548
chr15	38402895	38403952	1057	chr15	38417185	38449021	Azin1	-	31836	13233
chr15	38464965	38467882	2917	chr15	38417185	38449021	Azin1	-	31836	15944
chr15	38496058	38498220	2162	chr15	38417185	38449021	Azin1	-	31836	47037
chr15	38530730	38532696	1966	chr15	38591659	38622198	Atp6v1c1	+	30539	58963
chr15	38549333	38551453	2120	chr15	38591659	38622198	Atp6v1c1	+	30539	40206
chr15	42009210	42010210	1000	chr15	41780543	41780644	SNORA17	+	101	228566
chr15	50191816	50195308	3492	chr15	50486307	50721587	Trps1	-	235280	290999
chr15	52588860	52591192	2332	chr15	52544000	52561986	Med30	+	17986	26874
chr15	53230457	53233099	2642	chr15	52895593	53177714	Ext1	-	282121	52743
chr15	53240358	53241358	1000	chr15	53293176	53734092	Samd12	-	440916	51818
chr15	53245620	53247598	1978	chr15	53293176	53734092	Samd12	-	440916	45578
chr15	57806640	57808485	1845	chr15	57743754	57801623	Wdr67	+	57869	5017
chr15	58920904	58922710	1806	chr15	58772799	58913581	Mtss1	-	140782	7323
chr15	58936709	58938428	1719	chr15	58772799	58913581	Mtss1	-	140782	23128
chr15	58976946	58978098	1152	chr15	58772799	58913581	Mtss1	-	140782	63365
chr15	59094753	59095844	1091	chr15	59146632	59162747	Sqle	+	16115	50788
chr15	59449315	59450315	1000	chr15	59205753	59433238	Nsmce2	+	227485	16077
chr15	59450648	59452500	1852	chr15	59205753	59433238	Nsmce2	+	227485	17410
chr15	59511696	59512843	1147	chr15	59479905	59488105	Trib1	+	8200	23591
chr15	59552510	59555244	2734	chr15	59479905	59488105	Trib1	+	8200	64405
chr15	59561393	59563615	2222	chr15	59479905	59488105	Trib1	+	8200	73288
chr15	59569086	59572215	3129	chr15	59479905	59488105	Trib1	+	8200	80981
chr15	59626505	59628431	1926	chr15	59479905	59488105	Trib1	+	8200	138400
chr15	59781733	59782989	1256	chr15	59825985	59826383	Gm7713	-	398	42996
chr15	59932383	59933383	1000	chr15	59916343	59916449	U6	+	106	15934
chr15	59971452	59974963	3511	chr15	59916343	59916449	U6	+	106	55003
chr15	60999869	61000869	1000	chr15	61189426	61189559	SNORA42	-	133	188557
chr15	61241915	61245744	3829	chr15	61189426	61189559	SNORA42	-	133	52356
chr15	61247193	61248193	1000	chr15	61189426	61189559	SNORA42	-	133	57634
chr15	61272479	61273690	1211	chr15	61189426	61189559	SNORA42	-	133	82920
chr15	61285600	61287507	1907	chr15	61189426	61189559	SNORA42	-	133	96041
chr15	61369663	61370694	1031	chr15	61189426	61189559	SNORA42	-	133	180104
chr15	61371797	61372875	1078	chr15	61189426	61189559	SNORA42	-	133	182238
chr15	61377085	61380701	3616	chr15	61189426	61189559	SNORA42	-	133	187526
chr15	62262604	62265487	2883	chr15	61869542	62209651	Pvt1	+	340109	52953
chr15	62269035	62271357	2322	chr15	61869542	62209651	Pvt1	+	340109	59384
chr15	62291488	62293400	1912	chr15	61869542	62209651	Pvt1	+	340109	81837
chr15	62313254	62315501	2247	chr15	61869542	62209651	Pvt1	+	340109	103603
chr15	62317170	62320030	2860	chr15	61869542	62209651	Pvt1	+	340109	107519
chr15	62557304	62560195	2891	chr15	62624756	62624889	SNORA17	+	133	64561
chr15	62565539	62567318	1779	chr15	62624756	62624889	SNORA17	+	133	57438
chr15	62617343	62618910	1567	chr15	62624756	62624889	SNORA17	+	133	5846
chr15	62631299	62635197	3898	chr15	62624756	62624889	SNORA17	+	133	6410
chr15	62637729	62641835	4106	chr15	62624756	62624889	SNORA17	+	133	12840
chr15	62652535	62655915	3380	chr15	62624756	62624889	SNORA17	+	133	27646
chr15	63483393	63484507	1114	chr15	63607526	63640314	Gsdmc	-	32788	123019
chr15	63906253	63908206	1953	chr15	63918419	64214481	Asap1	-	296062	10213
chr15	65575677	65576823	1146	chr15	65618596	65705378	Efr3a	+	86782	41773
chr15	66687388	66688923	1535	chr15	66502315	66682283	Tg	+	179968	5105
chr15	66689167	66692463	3296	chr15	66502315	66682283	Tg	+	179968	6884
chr15	66692576	66694271	1695	chr15	66502315	66682283	Tg	+	179968	10293
chr15	66695922	66699243	3321	chr15	66502315	66682283	Tg	+	179968	13639
chr15	66870639	66871722	1083	chr15	66853540	66853599	U7	+	59	17040
chr15	66893136	66895361	2225	chr15	66934437	66945922	St3gal1	-	11485	39076
chr15	66968688	66971606	2918	chr15	66934437	66945922	St3gal1	-	11485	22766
chr15	66974703	66978209	3506	chr15	66934437	66945922	St3gal1	-	11485	28781
chr15	66978248	66981491	3243	chr15	66934437	66945922	St3gal1	-	11485	32326
chr15	66983972	66986596	2624	chr15	66934437	66945922	St3gal1	-	11485	38050
chr15	67004054	67006446	2392	chr15	66934437	66945922	St3gal1	-	11485	58132
chr15	67007337	67009230	1893	chr15	66934437	66945922	St3gal1	-	11485	61415
chr15	67120766	67122347	1581	chr15	66934437	66945922	St3gal1	-	11485	174844
chr15	67226686	67227686	1000	chr15	66934437	66945922	St3gal1	-	11485	280764
chr15	67312453	67314222	1769	chr15	66934437	66945922	St3gal1	-	11485	366531
chr15	67544576	67546985	2409	chr15	67915328	68090418	Zfat	-	175090	368343
chr15	72153053	72154993	1940	chr15	72085780	72085886	U6	-	106	67167
chr15	72897012	72898980	1968	chr15	72420051	72891634	Trappc9	-	471583	5378
chr15	73322046	73323046	1000	chr15	73342990	73402672	Dennd3	+	59682	19944
chr15	73497756	73498756	1000	chr15	73407854	73476192	Slc45a4	-	68338	21564
chr15	74735996	74737895	1899	chr15	74708766	74712134	2010109I03Rik	-	3368	23862
chr15	74738812	74741284	2472	chr15	74708766	74712134	2010109I03Rik	-	3368	26678
chr15	74746159	74749879	3720	chr15	74708766	74712134	2010109I03Rik	-	3368	34025
chr15	74750298	74752418	2120	chr15	74785481	74790335	Ly6e	+	4854	33063
chr15	74764370	74765940	1570	chr15	74785481	74790335	Ly6e	+	4854	19541
chr15	74796562	74799204	2642	chr15	74785481	74790335	Ly6e	+	4854	6227
chr15	75472168	75473571	1403	chr15	75487465	75509230	Top1mt	-	21765	13894
chr15	76755132	76756766	1634	chr15	76741281	76748440	Zfp647	-	7159	6692
chr15	77692188	77695505	3317	chr15	77591017	77672605	Myh9	-	81588	19583
chr15	78340484	78341627	1143	chr15	78353776	78360055	C1qtnf6	-	6279	12149
chr15	78411345	78412444	1099	chr15	78389599	78403213	Rac2	-	13614	8132
chr15	78413335	78414954	1619	chr15	78389599	78403213	Rac2	-	13614	10122
chr15	78416956	78418604	1648	chr15	78427477	78452449	Cyth4	+	24972	8873
chr15	79712540	79714825	2285	chr15	79722089	79746336	Apobec3	+	24247	7264
chr15	79890757	79893912	3155	chr15	79908211	79913836	Rpl3	-	5625	14299
chr15	79901932	79902932	1000	chr15	79908211	79913836	Rpl3	-	5625	5279
chr15	80402129	80403303	1174	chr15	80282670	80390900	Enthd1	-	108230	11229
chr15	80423138	80425456	2318	chr15	80453935	80480989	Grap2	+	27054	28479
chr15	80429650	80430779	1129	chr15	80453935	80480989	Grap2	+	27054	23156
chr15	80432511	80433959	1448	chr15	80453935	80480989	Grap2	+	27054	19976
chr15	80437454	80438454	1000	chr15	80453935	80480989	Grap2	+	27054	15481
chr15	80444283	80446771	2488	chr15	80453935	80480989	Grap2	+	27054	7164
chr15	80540819	80542417	1598	chr15	80501783	80530850	Fam83f	+	29067	9969
chr15	80549017	80550805	1788	chr15	80501783	80530850	Fam83f	+	29067	18167
chr15	80563962	80567263	3301	chr15	80590016	80771516	Tnrc6b	+	181500	22753
chr15	80573260	80575051	1791	chr15	80590016	80771516	Tnrc6b	+	181500	14965
chr15	81029373	81030975	1602	chr15	81021204	81023193	4930483J18Rik	+	1989	6180
chr15	81040056	81041942	1886	chr15	81021204	81023193	4930483J18Rik	+	1989	16863
chr15	81130152	81132900	2748	chr15	81149351	81191195	Slc25a17	-	41844	16451
chr15	81137653	81139769	2116	chr15	81149351	81191195	Slc25a17	-	41844	9582
chr15	81341929	81343927	1998	chr15	81329514	81329978	Gm5218	-	464	11951
chr15	81344016	81345874	1858	chr15	81329514	81329978	Gm5218	-	464	14038
chr15	81364106	81365394	1288	chr15	81329514	81329978	Gm5218	-	464	34128
chr15	81366102	81367173	1071	chr15	81329514	81329978	Gm5218	-	464	36124
chr15	81397938	81400413	2475	chr15	81415781	81482507	Ep300	+	66726	15368
chr15	81662547	81663547	1000	chr15	81632851	81657291	Tef	+	24440	5256
chr15	84342458	84343458	1000	chr15	84383828	84387922	Ldoc1l	-	4094	40370
chr15	84367151	84368151	1000	chr15	84383828	84387922	Ldoc1l	-	4094	15677
chr15	84406820	84408047	1227	chr15	84383828	84387922	Ldoc1l	-	4094	18898
chr15	85440796	85442094	1298	chr15	85411572	85424138	AU022754	+	12566	16658
chr15	85464111	85465948	1837	chr15	85411572	85424138	AU022754	+	12566	39973
chr15	85474877	85477250	2373	chr15	85411572	85424138	AU022754	+	12566	50739
chr15	85483530	85484837	1307	chr15	85537033	85537127	Mirlet7c-2	+	94	52196
chr15	85487535	85488676	1141	chr15	85537033	85537127	Mirlet7c-2	+	94	48357
chr15	85500785	85501785	1000	chr15	85537033	85537127	Mirlet7c-2	+	94	35248
chr15	85880812	85882831	2019	chr15	85888125	85968064	Gramd4	+	79939	5294
chr15	88319807	88321775	1968	chr15	88430745	88431972	Zdhhc25	+	1227	108970
chr15	88684171	88687599	3428	chr15	88692616	88696150	Pim3	+	3534	5017
chr15	91462420	91464410	1990	chr15	91447583	91447868	7SK	-	285	14552
chr15	91473988	91475634	1646	chr15	91447583	91447868	7SK	-	285	26120
chr15	91480635	91483444	2809	chr15	91503606	91646551	Lrrk2	+	142945	20162
chr15	91488442	91489535	1093	chr15	91503606	91646551	Lrrk2	+	142945	14071
chr15	91490644	91492219	1575	chr15	91503606	91646551	Lrrk2	+	142945	11387
chr15	94306458	94307539	1081	chr15	94100594	94295849	Adamts20	-	195255	10609
chr15	94308232	94310243	2011	chr15	94100594	94295849	Adamts20	-	195255	12383
chr15	96297252	96300702	3450	chr15	96242129	96291274	Scaf11	-	49145	5978
chr15	96304559	96306505	1946	chr15	96242129	96291274	Scaf11	-	49145	13285
chr15	96350177	96351768	1591	chr15	96401849	96473344	Slc38a1	-	71495	50081
chr15	96372772	96374378	1606	chr15	96401849	96473344	Slc38a1	-	71495	27471
chr15	96484624	96486196	1572	chr15	96401849	96473344	Slc38a1	-	71495	11280
chr15	96537577	96538577	1000	chr15	96517825	96530129	Slc38a2	-	12304	7448
chr15	96539400	96541152	1752	chr15	96517825	96530129	Slc38a2	-	12304	9271
chr15	96543644	96546325	2681	chr15	96517825	96530129	Slc38a2	-	12304	13515
chr15	96575029	96576431	1402	chr15	96517825	96530129	Slc38a2	-	12304	44900
chr15	96585695	96588589	2894	chr15	96517825	96530129	Slc38a2	-	12304	55566
chr15	96782380	96783972	1592	chr15	96825254	96886387	Slc38a4	-	61133	41282
chr15	97285653	97287192	1539	chr15	97077538	97216120	Fam113b	+	138582	69533
chr15	97288372	97289864	1492	chr15	97077538	97216120	Fam113b	+	138582	72252
chr15	97292202	97296664	4462	chr15	97077538	97216120	Fam113b	+	138582	76082
chr15	97298987	97300184	1197	chr15	97077538	97216120	Fam113b	+	138582	82867
chr15	97328718	97329956	1238	chr15	97077538	97216120	Fam113b	+	138582	112598
chr15	97493945	97495001	1056	chr15	97505536	97536253	Rpap3	-	30717	10535
chr15	100273176	100274951	1775	chr15	100280115	100280224	n-R5s43	+	109	5164
chr15	100584575	100586197	1622	chr15	100592178	100654399	Slc4a8	+	62221	5981
chr15	101076008	101077710	1702	chr15	101054638	101063186	Grasp	+	8548	12822
chr15	101083045	101085367	2322	chr15	101097277	101105223	Nr4a1	+	7946	11910
chr15	101086183	101090106	3923	chr15	101097277	101105223	Nr4a1	+	7946	7171
chr15	101147470	101150898	3428	chr15	101123643	101127046	6030408B16Rik	+	3403	20424
chr15	101217496	101218844	1348	chr15	101177875	101200556	Krt80	-	22681	16940
chr15	101807216	101808216	1000	chr15	101827142	101834773	Krt8	-	7631	18926
chr15	101814133	101815240	1107	chr15	101827142	101834773	Krt8	-	7631	11902
chr15	102572904	102575494	2590	chr15	102537210	102552609	Calcoco1	-	15399	20295
chr15	5382578	5383578	1000	chr15	5156661	5194187	Ptger4	-	37526	188391
chr15	5414786	5415786	1000	chr15	5156661	5194187	Ptger4	-	37526	220599
chr15	5464240	5465258	1018	chr15	5156661	5194187	Ptger4	-	37526	270053
chr15	8518483	8520314	1831	chr15	8479135	8479434	Gm2348	-	299	39049
chr15	8526974	8527974	1000	chr15	8479135	8479434	Gm2348	-	299	47540
chr15	8565065	8567103	2038	chr15	8584124	8660764	Slc1a3	-	76640	17021
chr15	9484860	9485860	1000	chr15	9507948	9678623	Spef2	-	170675	22088
chr15	11645785	11646785	1000	chr15	11769651	11835429	Npr3	-	65778	122866
chr15	11940014	11941494	1480	chr15	11911094	11926738	Sub1	-	15644	13276
chr15	11983513	11984513	1000	chr15	11911094	11926738	Sub1	-	15644	56775
chr15	12033029	12035079	2050	chr15	12047586	12115438	Zfr	+	67852	12507
chr15	20806970	20807970	1000	chr15	20838627	20838754	SNORA17	+	127	30657
chr15	25285142	25286142	1000	chr15	25293040	25343519	Basp1	-	50479	6898
chr15	25758136	25759272	1136	chr15	25773019	25903442	Fam134b	+	130423	13747
chr15	27632090	27633292	1202	chr15	27584826	27611262	Fam105a	-	26436	20828
chr15	28088536	28089582	1046	chr15	28133507	28401800	Dnahc5	+	268293	43925
chr15	33972883	33974313	1430	chr15	34012449	34072141	Mtdh	+	59692	38136
chr15	33975990	33977151	1161	chr15	34012449	34072141	Mtdh	+	59692	35298
chr15	36656997	36658080	1083	chr15	36700525	36724302	Ywhaz	-	23777	42445
chr15	36867795	36869547	1752	chr15	36926786	36937157	Zfp706	-	10371	57239
chr15	38111880	38112887	1007	chr15	38148958	38156490	Odf1	+	7532	36071
chr15	38382080	38383080	1000	chr15	38417185	38449021	Azin1	-	31836	34105
chr15	38473238	38474238	1000	chr15	38417185	38449021	Azin1	-	31836	24217
chr15	38640179	38641179	1000	chr15	38656628	38837731	Gm17265	-	181103	15449
chr15	44130343	44131343	1000	chr15	44177196	44177321	SNORA17	+	125	45853
chr15	58984551	58985551	1000	chr15	59042458	59043338	Gm5045	+	880	56907
chr15	59559814	59560932	1118	chr15	59479905	59488105	Trib1	+	8200	71709
chr15	61273707	61274707	1000	chr15	61189426	61189559	SNORA42	-	133	84148
chr15	62288880	62289880	1000	chr15	61869542	62209651	Pvt1	+	340109	79229
chr15	62649953	62650953	1000	chr15	62624756	62624889	SNORA17	+	133	25064
chr15	62655934	62657097	1163	chr15	62624756	62624889	SNORA17	+	133	31045
chr15	63479364	63480794	1430	chr15	63607526	63640314	Gsdmc	-	32788	126732
chr15	74726984	74728966	1982	chr15	74708766	74712134	2010109I03Rik	-	3368	14850
chr15	74754110	74755197	1087	chr15	74785481	74790335	Ly6e	+	4854	30284
chr15	74761924	74764217	2293	chr15	74785481	74790335	Ly6e	+	4854	21264
chr15	78419434	78420548	1114	chr15	78427477	78452449	Cyth4	+	24972	6929
chr15	79855049	79857176	2127	chr15	79826330	79845238	Pdgfb	-	18908	9811
chr15	81352679	81353791	1112	chr15	81329514	81329978	Gm5218	-	464	22701
chr15	81376293	81377293	1000	chr15	81415781	81482507	Ep300	+	66726	38488
chr15	82042354	82044328	1974	chr15	81977696	82035806	Srebf2	+	58110	6548
chr15	86032997	86034185	1188	chr15	86042984	86043087	U6	-	103	8799
chr15	97012867	97014246	1379	chr15	97074505	97077718	Amigo2	-	3213	60259
chr15	97254671	97255884	1213	chr15	97077538	97216120	Fam113b	+	138582	38551
chr15	97279395	97280395	1000	chr15	97077538	97216120	Fam113b	+	138582	63275
chr15	97411981	97413099	1118	chr15	97505536	97536253	Rpap3	-	30717	92437
chr15	98341225	98342662	1437	chr15	98349243	98364669	2310037I24Rik	-	15426	6581
chr16	3632488	3633488	1000	chr16	3592398	3593339	Olfr161	+	941	39149
chr16	3698790	3700217	1427	chr16	3707215	3718124	Mefv	-	10909	6998
chr16	3813012	3816276	3264	chr16	3838975	3839913	Olfr15	+	938	22699
chr16	3819714	3820714	1000	chr16	3838975	3839913	Olfr15	+	938	18261
chr16	4468963	4470803	1840	chr16	4480216	4541816	Srl	-	61600	9413
chr16	4585949	4587734	1785	chr16	4594713	4624924	Glis2	+	30211	6979
chr16	5473317	5474481	1164	chr16	5324129	5324250	n-R5s30	-	121	149067
chr16	8810788	8811964	1176	chr16	8830193	8859009	1810013L24Rik	+	28816	18229
chr16	8823081	8824769	1688	chr16	8830193	8859009	1810013L24Rik	+	28816	5424
chr16	9175469	9176978	1509	chr16	8996178	8996459	Gm17697	-	281	179010
chr16	10753832	10754832	1000	chr16	10545457	10744971	Clec16a	+	199514	8861
chr16	10757773	10759330	1557	chr16	10545457	10744971	Clec16a	+	199514	12802
chr16	10768325	10772816	4491	chr16	10783901	10785629	Socs1	-	1728	11085
chr16	10774361	10775575	1214	chr16	10783901	10785629	Socs1	-	1728	8326
chr16	11285117	11287153	2036	chr16	11313905	11320167	Tnfrsf17	+	6262	26752
chr16	12872483	12873483	1000	chr16	12760104	12761513	Gm6327	-	1409	110970
chr16	13753863	13755568	1705	chr16	13729929	13737673	1810007I06Rik	+	7744	16190
chr16	14350307	14353859	3552	chr16	14361651	14475830	Abcc1	+	114179	7792
chr16	19012297	19016842	4545	chr16	19028325	19028747	Gm10088	+	422	11483
chr16	19052312	19053921	1609	chr16	19065327	19067266	Iglc3	-	1939	11406
chr16	19181527	19186401	4874	chr16	19198494	19200444	Iglc2	-	1950	12093
chr16	19217821	19218830	1009	chr16	19198494	19200444	Iglc2	-	1950	17377
chr16	19833602	19835106	1504	chr16	19876663	19883990	A930003A15Rik	-	7327	41557
chr16	21332577	21333688	1111	chr16	21247591	21296945	Gm16863	-	49354	35632
chr16	21382090	21383090	1000	chr16	21423191	21644753	Vps8	+	221562	40101
chr16	21727714	21728801	1087	chr16	21761360	21787917	Ehhadh	-	26557	32559
chr16	23094826	23095826	1000	chr16	23107517	23114209	Eif4a2	+	6692	11691
chr16	23135551	23136616	1065	chr16	23114016	23127810	Rfc4	-	13794	7741
chr16	23140374	23141468	1094	chr16	23146609	23158101	Adipoq	+	11492	5141
chr16	23374291	23375447	1156	chr16	23224813	23360421	St6gal1	+	135608	13870
chr16	23401539	23403552	2013	chr16	23423495	23423808	7SK	-	313	19943
chr16	24135079	24136979	1900	chr16	23965138	23988938	Bcl6	-	23800	146141
chr16	24150707	24152473	1766	chr16	23965138	23988938	Bcl6	-	23800	161769
chr16	24164350	24166611	2261	chr16	23965138	23988938	Bcl6	-	23800	175412
chr16	24295961	24298784	2823	chr16	24391698	24393674	1110054M08Rik	-	1976	92914
chr16	24333675	24336232	2557	chr16	24391698	24393674	1110054M08Rik	-	1976	55466
chr16	24337966	24344007	6041	chr16	24391698	24393674	1110054M08Rik	-	1976	47691
chr16	24346406	24348892	2486	chr16	24391698	24393674	1110054M08Rik	-	1976	42806
chr16	24363557	24364557	1000	chr16	24391698	24393674	1110054M08Rik	-	1976	27141
chr16	25010113	25012160	2047	chr16	24393436	24992662	Lpp	+	599226	17451
chr16	25024345	25025345	1000	chr16	24393436	24992662	Lpp	+	599226	31683
chr16	25248224	25249224	1000	chr16	25286903	25422430	Tprg	+	135527	37679
chr16	25249264	25250727	1463	chr16	25286903	25422430	Tprg	+	135527	36176
chr16	27182823	27184774	1951	chr16	27307575	27351298	Ostn	+	43723	122801
chr16	28944201	28945201	1000	chr16	28826262	28929784	1600021P15Rik	-	103522	14417
chr16	29775453	29776691	1238	chr16	29811144	29837900	Gm17734	+	26756	34453
chr16	29981321	29982745	1424	chr16	29958579	29962393	Gm1968	-	3814	18928
chr16	30227332	30228495	1163	chr16	30200996	30205965	Gm17516	-	4969	21367
chr16	30233204	30236863	3659	chr16	30256464	30267618	Cpn2	-	11154	19601
chr16	30623547	30625238	1691	chr16	30599809	30602883	Fam43a	+	3074	20664
chr16	30633807	30635507	1700	chr16	30599809	30602883	Fam43a	+	3074	30924
chr16	30644463	30647559	3096	chr16	30599809	30602883	Fam43a	+	3074	41580
chr16	30685711	30687770	2059	chr16	30599809	30602883	Fam43a	+	3074	82828
chr16	30835226	30837117	1891	chr16	30814248	30814354	U6	+	106	20872
chr16	31233472	31235105	1633	chr16	31251623	31275363	Ppp1r2	-	23740	16518
chr16	31235254	31236719	1465	chr16	31251623	31275363	Ppp1r2	-	23740	14904
chr16	32129273	32130412	1139	chr16	32142871	32165680	Lrrc33	-	22809	12459
chr16	32200097	32201149	1052	chr16	32186278	32186976	Bex6	+	698	13121
chr16	32202195	32203822	1627	chr16	32186278	32186976	Bex6	+	698	15219
chr16	33672071	33673877	1806	chr16	33517414	33664221	Slc12a8	+	146807	7850
chr16	35889025	35890910	1885	chr16	35832960	35871630	Parp14	-	38670	17395
chr16	36097429	36099668	2239	chr16	36071746	36092204	Ccdc58	+	20458	5225
chr16	36475647	36478759	3112	chr16	36493782	36562227	Casr	-	68445	15023
chr16	36674035	36676316	2281	chr16	36603955	36666167	Cd86	-	62212	7868
chr16	36681845	36682845	1000	chr16	36694064	36726890	Ildr1	+	32826	11219
chr16	36683688	36685688	2000	chr16	36694064	36726890	Ildr1	+	32826	8376
chr16	37684696	37685739	1043	chr16	37647256	37654539	Ndufb4	-	7283	30157
chr16	38015237	38018380	3143	chr16	37916582	38007613	Gpr156	+	91031	7624
chr16	42189581	42191238	1657	chr16	41532971	42181792	Lsamp	+	648821	7789
chr16	43709250	43710349	1099	chr16	43648974	43664297	Tigit	-	15323	44953
chr16	44062763	44063909	1146	chr16	44085515	44139818	Atp6v1a	-	54303	21606
chr16	44992867	44994821	1954	chr16	44943791	44981493	Cd200r3	+	37702	11374
chr16	44999249	45000813	1564	chr16	44943791	44981493	Cd200r3	+	37702	17756
chr16	45004662	45005723	1061	chr16	44943791	44981493	Cd200r3	+	37702	23169
chr16	45282641	45284189	1548	chr16	45224428	45253008	Btla	+	28580	29633
chr16	45330266	45331266	1000	chr16	45382248	45409166	Cd200	-	26918	50982
chr16	45346411	45348085	1674	chr16	45382248	45409166	Cd200	-	26918	34163
chr16	45348885	45351690	2805	chr16	45382248	45409166	Cd200	-	26918	30558
chr16	45370863	45374667	3804	chr16	45382248	45409166	Cd200	-	26918	7581
chr16	48790110	48791110	1000	chr16	48732023	48772251	Trat1	-	40228	17859
chr16	48796268	48799477	3209	chr16	48816969	48819004	Retnlb	+	2035	17492
chr16	49500152	49501261	1109	chr16	49699346	49765239	Ift57	+	65893	198085
chr16	49503426	49504767	1341	chr16	49699346	49765239	Ift57	+	65893	194579
chr16	49818119	49819592	1473	chr16	49800646	49804987	Gm16619	+	4341	13132
chr16	49839553	49840625	1072	chr16	49855731	49915123	Cd47	+	59392	15106
chr16	49935554	49939012	3458	chr16	49855731	49915123	Cd47	+	59392	20431
chr16	49969765	49971722	1957	chr16	49855731	49915123	Cd47	+	59392	54642
chr16	49981615	49983380	1765	chr16	49855731	49915123	Cd47	+	59392	66492
chr16	50026083	50027806	1723	chr16	49855731	49915123	Cd47	+	59392	110960
chr16	50045466	50046690	1224	chr16	49855731	49915123	Cd47	+	59392	130343
chr16	50699315	50701396	2081	chr16	50719410	50732862	5330426P16Rik	-	13452	18014
chr16	51369496	51370496	1000	chr16	51362565	51363945	Gm6767	-	1380	5551
chr16	52013367	52014367	1000	chr16	52031662	52208160	Cblb	+	176498	17295
chr16	52468868	52471409	2541	chr16	52249109	52454187	Alcam	-	205078	14681
chr16	55554802	55556145	1343	chr16	55594895	55595001	U6	-	106	38750
chr16	55582507	55583859	1352	chr16	55594895	55595001	U6	-	106	11036
chr16	55622709	55623863	1154	chr16	55594895	55595001	U6	-	106	27708
chr16	55636503	55637971	1468	chr16	55594895	55595001	U6	-	106	41502
chr16	55697997	55699685	1688	chr16	55779158	55779257	U6	-	99	79473
chr16	55753975	55755502	1527	chr16	55779158	55779257	U6	-	99	23656
chr16	55756780	55758665	1885	chr16	55779158	55779257	U6	-	99	20493
chr16	55787328	55790569	3241	chr16	55779158	55779257	U6	-	99	8071
chr16	55948918	55955325	6407	chr16	55966388	56009026	Rpl24	+	42638	11063
chr16	56061566	56062632	1066	chr16	56070676	56070779	AC171202.1	+	103	8044
chr16	56063940	56065077	1137	chr16	56070676	56070779	AC171202.1	+	103	5599
chr16	57029667	57031389	1722	chr16	57037080	57071459	2310005G13Rik	-	34379	5691
chr16	57245914	57247680	1766	chr16	57168979	57231579	Tbc1d23	-	62600	14335
chr16	57259160	57260349	1189	chr16	57266252	57292978	Tmem30c	-	26726	5903
chr16	58685513	58686664	1151	chr16	58670321	58680504	Cpox	+	10183	5009
chr16	58689572	58691035	1463	chr16	58670321	58680504	Cpox	+	10183	9068
chr16	58696783	58697861	1078	chr16	58670321	58680504	Cpox	+	10183	16279
chr16	58702430	58703548	1118	chr16	58717548	58718837	Gpr15	-	1289	14000
chr16	60895791	60896791	1000	chr16	61058587	61058825	Gm17065	+	238	161796
chr16	64823163	64825424	2261	chr16	64851822	64859333	Cggbp1	+	7511	26398
chr16	64872984	64874082	1098	chr16	64851822	64859333	Cggbp1	+	7511	13651
chr16	65576865	65578355	1490	chr16	65539378	65562942	Chmp2b	-	23564	13923
chr16	76040821	76042529	1708	chr16	75859038	76022515	Samsn1	-	163477	18306
chr16	76047111	76049509	2398	chr16	75859038	76022515	Samsn1	-	163477	24596
chr16	76416177	76417177	1000	chr16	76403454	76403957	Gm9843	-	503	12220
chr16	76532583	76533583	1000	chr16	76403454	76403957	Gm9843	-	503	128626
chr16	76678999	76682447	3448	chr16	76403454	76403957	Gm9843	-	503	275042
chr16	78198151	78200043	1892	chr16	78240503	78240633	SNORA17	+	130	40460
chr16	78264678	78265801	1123	chr16	78240503	78240633	SNORA17	+	130	24045
chr16	78490326	78491595	1269	chr16	78544257	78576902	D16Ertd472e	-	32645	52662
chr16	84605416	84606416	1000	chr16	84620052	84620373	7SK	-	321	13636
chr16	84627261	84628927	1666	chr16	84620052	84620373	7SK	-	321	6888
chr16	84640903	84642807	1904	chr16	84620052	84620373	7SK	-	321	20530
chr16	84654007	84655007	1000	chr16	84620052	84620373	7SK	-	321	33634
chr16	84681558	84683472	1914	chr16	84713268	84715487	Mir155	+	2219	29796
chr16	84702353	84704360	2007	chr16	84713268	84715487	Mir155	+	2219	8908
chr16	87652375	87654209	1834	chr16	87621259	87621365	U6	-	106	31010
chr16	87660702	87662277	1575	chr16	87699190	87733591	Bach1	+	34401	36913
chr16	90177087	90178087	1000	chr16	89787356	90144014	Tiam1	-	356658	33073
chr16	90196883	90198622	1739	chr16	90220987	90226567	Sod1	+	5580	22365
chr16	90299357	90302565	3208	chr16	90229202	90284670	Scaf4	-	55468	14687
chr16	91366049	91367916	1867	chr16	91373028	91405834	Ifnar2	+	32806	5112
chr16	91431812	91434822	3010	chr16	91406409	91426079	Il10rb	+	19670	5733
chr16	91446903	91448793	1890	chr16	91465349	91470366	A930006K02Rik	+	5017	16556
chr16	91451139	91453996	2857	chr16	91465349	91470366	A930006K02Rik	+	5017	11353
chr16	91455333	91457243	1910	chr16	91465349	91470366	A930006K02Rik	+	5017	8106
chr16	91529982	91532095	2113	chr16	91539427	91540305	Gm7860	-	878	7332
chr16	92863436	92864857	1421	chr16	92601712	92826311	Runx1	-	224599	37125
chr16	92873608	92874750	1142	chr16	92601712	92826311	Runx1	-	224599	47297
chr16	92900016	92901207	1191	chr16	92601712	92826311	Runx1	-	224599	73705
chr16	92903674	92904674	1000	chr16	92601712	92826311	Runx1	-	224599	77363
chr16	93020020	93021020	1000	chr16	92601712	92826311	Runx1	-	224599	193709
chr16	93027502	93029375	1873	chr16	92601712	92826311	Runx1	-	224599	201191
chr16	93031784	93033316	1532	chr16	92601712	92826311	Runx1	-	224599	205473
chr16	93109774	93110774	1000	chr16	93369965	93370061	Mir802	+	96	259191
chr16	93815900	93816998	1098	chr16	93712152	93810830	Dopey2	+	98678	5070
chr16	93823131	93824131	1000	chr16	93832366	93876317	Morc3	+	43951	8235
chr16	94945359	94947219	1860	chr16	94970873	95219303	Kcnj6	-	248430	23654
chr16	94957829	94958998	1169	chr16	94970873	95219303	Kcnj6	-	248430	11875
chr16	95230782	95231782	1000	chr16	95237977	95288624	Gm17496	+	50647	6195
chr16	95949020	95951427	2407	chr16	95923682	95942658	Ets2	+	18976	6362
chr16	95970286	95972356	2070	chr16	95923682	95942658	Ets2	+	18976	27628
chr16	95973618	95974714	1096	chr16	95923682	95942658	Ets2	+	18976	30960
chr16	95990595	95991595	1000	chr16	96027636	96029924	2810404F17Rik	-	2288	36041
chr16	96001805	96004437	2632	chr16	96027636	96029924	2810404F17Rik	-	2288	23199
chr16	96762085	96763589	1504	chr16	96689213	96747400	Pcp4	+	58187	14685
chr16	98277890	98278890	1000	chr16	98218488	98231165	B230307C23Rik	+	12677	46725
chr16	98302882	98303998	1116	chr16	98218488	98231165	B230307C23Rik	+	12677	71717
chr16	3577627	3579243	1616	chr16	3592398	3593339	Olfr161	+	941	13155
chr16	10759451	10760566	1115	chr16	10545457	10744971	Clec16a	+	199514	14480
chr16	13160009	13161096	1087	chr16	13109777	13150710	Ercc4	+	40933	9299
chr16	13437189	13438337	1148	chr16	13449616	13449694	Mir193b	+	78	11279
chr16	19007384	19008859	1475	chr16	19028325	19028747	Gm10088	+	422	19466
chr16	19146541	19147831	1290	chr16	19198494	19200444	Iglc2	-	1950	50663
chr16	19152579	19153735	1156	chr16	19198494	19200444	Iglc2	-	1950	44759
chr16	19179388	19180597	1209	chr16	19198494	19200444	Iglc2	-	1950	17897
chr16	19232413	19233739	1326	chr16	19241304	19241772	Iglv3	-	468	7565
chr16	22698704	22700397	1693	chr16	22468534	22657294	Dgkg	-	188760	41410
chr16	29847337	29848956	1619	chr16	29811144	29837900	Gm17734	+	26756	9437
chr16	30187731	30188781	1050	chr16	30200996	30205965	Gm17516	-	4969	12215
chr16	30607908	30609024	1116	chr16	30599809	30602883	Fam43a	+	3074	5025
chr16	30613664	30615299	1635	chr16	30599809	30602883	Fam43a	+	3074	10781
chr16	30678263	30680061	1798	chr16	30599809	30602883	Fam43a	+	3074	75380
chr16	32124342	32125577	1235	chr16	32108951	32113829	Gm15729	+	4878	10513
chr16	32176879	32178324	1445	chr16	32186278	32186976	Bex6	+	698	7954
chr16	33156204	33157204	1000	chr16	33139936	33140334	RNaseP_nuc	-	398	15870
chr16	38729846	38731962	2116	chr16	38742377	38769162	B4galt4	+	26785	10415
chr16	43689774	43693572	3798	chr16	43648974	43664297	Tigit	-	15323	25477
chr16	43698933	43699984	1051	chr16	43648974	43664297	Tigit	-	15323	34636
chr16	49847833	49848860	1027	chr16	49855731	49915123	Cd47	+	59392	6871
chr16	49848905	49849905	1000	chr16	49855731	49915123	Cd47	+	59392	5826
chr16	49965607	49968151	2544	chr16	49855731	49915123	Cd47	+	59392	50484
chr16	55620343	55621343	1000	chr16	55594895	55595001	U6	-	106	25342
chr16	55621432	55622432	1000	chr16	55594895	55595001	U6	-	106	26431
chr16	55747289	55748500	1211	chr16	55779158	55779257	U6	-	99	30658
chr16	58589755	58590755	1000	chr16	58613799	58617091	Gm813	-	3292	23044
chr16	58703756	58705331	1575	chr16	58717548	58718837	Gpr15	-	1289	12217
chr16	76053881	76055025	1144	chr16	75859038	76022515	Samsn1	-	163477	31366
chr16	78586088	78587088	1000	chr16	78544257	78576902	D16Ertd472e	-	32645	9186
chr16	84583987	84585370	1383	chr16	84620052	84620373	7SK	-	321	34682
chr16	84606564	84607733	1169	chr16	84620052	84620373	7SK	-	321	12319
chr16	84638875	84639875	1000	chr16	84620052	84620373	7SK	-	321	18502
chr16	84646548	84648136	1588	chr16	84620052	84620373	7SK	-	321	26175
chr16	91355326	91356562	1236	chr16	91349947	91350029	U4	-	82	5297
chr16	91445388	91446761	1373	chr16	91465349	91470366	A930006K02Rik	+	5017	18588
chr16	91522584	91524087	1503	chr16	91513386	91514878	Gm7856	-	1492	7706
chr16	92019546	92020546	1000	chr16	92042922	92043019	U6	+	97	22376
chr16	92021732	92022803	1071	chr16	92042922	92043019	U6	+	97	20119
chr16	92864870	92866429	1559	chr16	92601712	92826311	Runx1	-	224599	38559
chr16	92867456	92868556	1100	chr16	92601712	92826311	Runx1	-	224599	41145
chr16	92868870	92870091	1221	chr16	92601712	92826311	Runx1	-	224599	42559
chr16	93574936	93576263	1327	chr16	93583702	93604308	Setd4	-	20606	7439
chr16	95974754	95975754	1000	chr16	95923682	95942658	Ets2	+	18976	32096
chr16	96036360	96038022	1662	chr16	96027636	96029924	2810404F17Rik	-	2288	6436
chr16	97744994	97745994	1000	chr16	97757690	97782506	Mx2	+	24816	11696
chr17	3091463	3093834	2371	chr17	3076578	3084183	Pisd-ps2	-	7605	7280
chr17	3101193	3103207	2014	chr17	3114972	3198855	Scaf8	+	83883	11765
chr17	3313968	3315015	1047	chr17	3326573	3519397	Tiam2	+	192824	11558
chr17	4475622	4476650	1028	chr17	4678020	4678126	U6	+	106	201370
chr17	4907556	4908693	1137	chr17	4994332	5347656	Arid1b	+	353324	85639
chr17	7038567	7040804	2237	chr17	7002739	7032339	Gm2885	-	29600	6228
chr17	7065461	7066670	1209	chr17	7099578	7099686	Mir692-1	-	108	32908
chr17	7368275	7369275	1000	chr17	7374464	7507662	Rps6ka2	+	133198	5189
chr17	7601206	7605140	3934	chr17	7568061	7589654	Gm9992	-	21593	11552
chr17	8401262	8403599	2337	chr17	8358366	8389669	Fgfr1op	+	31303	11593
chr17	8417903	8419097	1194	chr17	8429077	8449992	Ccr6	+	20915	9980
chr17	10285615	10286666	1051	chr17	10399336	10512245	Qk	-	112909	112670
chr17	12564214	12565214	1000	chr17	12571475	12612250	Plg	+	40775	6261
chr17	13337305	13339105	1800	chr17	13301483	13324657	Unc93a	-	23174	12648
chr17	15489188	15491525	2337	chr17	15504318	15513836	Dll1	-	9518	12793
chr17	17047630	17050962	3332	chr17	17088503	17111119	BC002059	+	22616	37541
chr17	17141397	17142845	1448	chr17	17088503	17111119	BC002059	+	22616	30278
chr17	17370470	17372592	2122	chr17	17452246	17456475	Gm6712	+	4229	79654
chr17	17430674	17432512	1838	chr17	17452246	17456475	Gm6712	+	4229	19734
chr17	17652522	17654795	2273	chr17	17664687	17761453	Lnpep	-	96766	9892
chr17	18694919	18696860	1941	chr17	18718691	18735121	Vmn2r96	+	16430	21831
chr17	18751999	18752999	1000	chr17	18718691	18735121	Vmn2r96	+	16430	16878
chr17	19095849	19096849	1000	chr17	19051286	19085035	Vmn2r97	+	33749	10814
chr17	19104703	19106399	1696	chr17	19051286	19085035	Vmn2r97	+	33749	19668
chr17	19580470	19583213	2743	chr17	19590289	19591486	Vmn2r-ps121	+	1197	7076
chr17	21506606	21507836	1230	chr17	21520712	21536229	Zfp677	+	15517	12876
chr17	21609685	21611351	1666	chr17	21587316	21602555	Zfp51	+	15239	7130
chr17	21786704	21787775	1071	chr17	21794549	21799507	3110052M02Rik	+	4958	6774
chr17	21816087	21817621	1534	chr17	21827733	21827991	Gm10509	+	258	10112
chr17	22217557	22218557	1000	chr17	22099519	22208135	Zfp943	+	108616	9422
chr17	22361498	22363030	1532	chr17	22281326	22303157	Zfp947	-	21831	58341
chr17	22451163	22452240	1077	chr17	22474956	22498367	Zfp944	-	23411	22716
chr17	22876025	22877866	1841	chr17	22921765	22954708	Gm16386	-	32943	43899
chr17	25579240	25581703	2463	chr17	25511230	25570728	Cacna1h	-	59498	8512
chr17	26654464	26656406	1942	chr17	26642535	26645464	Dusp1	-	2929	9000
chr17	26666905	26670668	3763	chr17	26679705	26680660	Gm8225	+	955	9037
chr17	26799368	26800882	1514	chr17	26698434	26793876	Ergic1	+	95442	5492
chr17	27316290	27318578	2288	chr17	27326546	27341383	Lemd2	-	14837	7968
chr17	27458896	27461002	2106	chr17	27479405	27481770	Gm10505	+	2365	18403
chr17	29540005	29541005	1000	chr17	29497859	29516605	Fgd2	+	18746	23400
chr17	29552715	29553984	1269	chr17	29497859	29516605	Fgd2	+	18746	36110
chr17	29568389	29569974	1585	chr17	29598841	29628870	Gm16912	-	30029	28867
chr17	29573429	29575218	1789	chr17	29598841	29628870	Gm16912	-	30029	23623
chr17	29575329	29576773	1444	chr17	29598841	29628870	Gm16912	-	30029	22068
chr17	29644666	29646525	1859	chr17	29656226	29656735	Gm17657	-	509	9701
chr17	29905940	29907109	1169	chr17	29826323	29853957	1110021J02Rik	-	27634	51983
chr17	31176109	31177732	1623	chr17	31194643	31252722	Abcg1	+	58079	16911
chr17	31829613	31831503	1890	chr17	31814878	31818667	Cryaa	+	3789	10946
chr17	31870988	31872612	1624	chr17	31814878	31818667	Cryaa	+	3789	52321
chr17	31875897	31876897	1000	chr17	31814878	31818667	Cryaa	+	3789	57230
chr17	31889699	31891424	1725	chr17	31814878	31818667	Cryaa	+	3789	71032
chr17	31956988	31958769	1781	chr17	31981193	31992737	Sik1	-	11544	22424
chr17	31964208	31966763	2555	chr17	31981193	31992737	Sik1	-	11544	14430
chr17	31967899	31970219	2320	chr17	31981193	31992737	Sik1	-	11544	10974
chr17	31970417	31971634	1217	chr17	31981193	31992737	Sik1	-	11544	9559
chr17	32007370	32009790	2420	chr17	31981193	31992737	Sik1	-	11544	14633
chr17	32011332	32014325	2993	chr17	31981193	31992737	Sik1	-	11544	18595
chr17	32042193	32043370	1177	chr17	32081714	32171453	Hsf2bp	-	89739	38344
chr17	32050412	32052844	2432	chr17	32081714	32171453	Hsf2bp	-	89739	28870
chr17	32064296	32066070	1774	chr17	32081714	32171453	Hsf2bp	-	89739	15644
chr17	32073717	32075070	1353	chr17	32081714	32171453	Hsf2bp	-	89739	6644
chr17	32075293	32076428	1135	chr17	32081714	32171453	Hsf2bp	-	89739	5286
chr17	32966396	32967530	1134	chr17	32956289	32959145	Zfp799	-	2856	7251
chr17	33031425	33033750	2325	chr17	33042016	33054023	Cyp4f14	-	12007	8266
chr17	33620522	33621522	1000	chr17	33661149	33690727	Adamts10	+	29578	39627
chr17	34237276	34239295	2019	chr17	34229285	34232179	H2-Oa	+	2894	5097
chr17	34240210	34242631	2421	chr17	34248965	34259262	Brd2	-	10297	6334
chr17	34305649	34306701	1052	chr17	34290017	34297168	H2-DMb1	+	7151	8481
chr17	34310467	34312084	1617	chr17	34318932	34324697	Psmb9	-	5765	6848
chr17	35949330	35950965	1635	chr17	35958629	35959868	Ier3	+	1239	7664
chr17	36451587	36452837	1250	chr17	36459803	36463100	H2-M10.1	-	3297	6966
chr17	43023768	43024989	1221	chr17	42929900	43013373	Cd2ap	-	83473	10395
chr17	43048081	43049672	1591	chr17	42929900	43013373	Cd2ap	-	83473	34708
chr17	43369734	43370734	1000	chr17	43407278	43461686	Gpr110	+	54408	36544
chr17	43693319	43695343	2024	chr17	43705047	43749150	Pla2g7	+	44103	9704
chr17	44500761	44501761	1000	chr17	44325521	44417117	Clic5	+	91596	83644
chr17	44554343	44556814	2471	chr17	44632936	44951746	Runx2	-	318810	76122
chr17	45353384	45354384	1000	chr17	45300176	45301117	Gm4766	-	941	52267
chr17	45456885	45458111	1226	chr17	45528841	45570656	Cdc5l	-	41815	70730
chr17	45990069	45991069	1000	chr17	45871455	45925543	Gm16862	+	54088	64526
chr17	46179404	46180404	1000	chr17	46153942	46169326	Vegfa	-	15384	10078
chr17	46181980	46183764	1784	chr17	46153942	46169326	Vegfa	-	15384	12654
chr17	46210251	46212451	2200	chr17	46247935	46265859	Mrps18a	+	17924	35484
chr17	46477372	46478575	1203	chr17	46440170	46465301	Abcc10	-	25131	12071
chr17	46975257	46976368	1111	chr17	46935065	46968362	BC032203	-	33297	6895
chr17	46988403	46990802	2399	chr17	46935065	46968362	BC032203	-	33297	20041
chr17	46992938	46994746	1808	chr17	46935065	46968362	BC032203	-	33297	24576
chr17	46997997	46998997	1000	chr17	47026165	47027354	A330017A19Rik	-	1189	27168
chr17	47190942	47192503	1561	chr17	47179533	47179988	Gm4945	-	455	10954
chr17	48083956	48084984	1028	chr17	48073039	48073395	Gm5228	+	356	10561
chr17	48126253	48127253	1000	chr17	48140328	48140521	Gm14871	-	193	13075
chr17	48175109	48177332	2223	chr17	48140328	48140521	Gm14871	-	193	34588
chr17	48177966	48179351	1385	chr17	48140328	48140521	Gm14871	-	193	37445
chr17	48237734	48238734	1000	chr17	48226582	48227870	1700067P10Rik	+	1288	9864
chr17	48242944	48245852	2908	chr17	48226582	48227870	1700067P10Rik	+	1288	15074
chr17	48725098	48726098	1000	chr17	48757148	48757279	SNORA17	+	131	31050
chr17	50090767	50091767	1000	chr17	50131582	50329999	Rftn1	-	198417	39815
chr17	50107671	50108671	1000	chr17	50131582	50329999	Rftn1	-	198417	22911
chr17	50347342	50349258	1916	chr17	50131582	50329999	Rftn1	-	198417	17343
chr17	50607736	50611453	3717	chr17	50648872	50827818	Plcl2	+	178946	37419
chr17	50638546	50639546	1000	chr17	50648872	50827818	Plcl2	+	178946	9326
chr17	51547118	51548570	1452	chr17	50872452	51318674	Tbc1d5	-	446222	228444
chr17	52042551	52044992	2441	chr17	51875512	51972615	Satb1	-	97103	69936
chr17	52201051	52202684	1633	chr17	51875512	51972615	Satb1	-	97103	228436
chr17	52215013	52216411	1398	chr17	51875512	51972615	Satb1	-	97103	242398
chr17	52218206	52219339	1133	chr17	51875512	51972615	Satb1	-	97103	245591
chr17	52287295	52291191	3896	chr17	52544362	52544442	AC121600.1	+	80	253171
chr17	52306169	52309136	2967	chr17	52544362	52544442	AC121600.1	+	80	235226
chr17	52321295	52322295	1000	chr17	52544362	52544442	AC121600.1	+	80	222067
chr17	52730566	52731566	1000	chr17	52865084	53044561	Kcnh8	+	179477	133518
chr17	56069103	56070224	1121	chr17	56077976	56084597	Zfp119b	-	6621	7752
chr17	56070241	56072428	2187	chr17	56077976	56084597	Zfp119b	-	6621	5548
chr17	57262161	57264421	2260	chr17	57244808	57247180	Tnfsf9	+	2372	14981
chr17	57273826	57276477	2651	chr17	57285420	57289200	Cd70	-	3780	8943
chr17	57278014	57280254	2240	chr17	57285420	57289200	Cd70	-	3780	5166
chr17	57473954	57476310	2356	chr17	57418523	57468659	Vav1	+	50136	5295
chr17	57476719	57478520	1801	chr17	57418523	57468659	Vav1	+	50136	8060
chr17	57483226	57484767	1541	chr17	57498109	57622952	Emr1	+	124843	13342
chr17	57808475	57814600	6125	chr17	57886988	57887099	U4	+	111	72388
chr17	64939362	64940362	1000	chr17	64950076	65104450	Man2a1	+	154374	9714
chr17	65112998	65113998	1000	chr17	64950076	65104450	Man2a1	+	154374	8548
chr17	69745152	69746152	1000	chr17	69732390	69740090	Zfp161	+	7700	5062
chr17	71838517	71839517	1000	chr17	71845440	71876197	Ndc80	-	30757	5923
chr17	73170545	73172331	1786	chr17	73186044	73200535	Ypel5	+	14491	13713
chr17	73237761	73240907	3146	chr17	73267645	73291282	Lbh	+	23637	26738
chr17	73252359	73253553	1194	chr17	73267645	73291282	Lbh	+	23637	14092
chr17	73296376	73299866	3490	chr17	73267645	73291282	Lbh	+	23637	5094
chr17	73315139	73316442	1303	chr17	73337138	73337244	U6	+	106	20696
chr17	73357288	73359609	2321	chr17	73337138	73337244	U6	+	106	20044
chr17	73382877	73384780	1903	chr17	73337138	73337244	U6	+	106	45633
chr17	73430313	73432145	1832	chr17	73457325	73592708	Lclat1	+	135383	25180
chr17	73444314	73445314	1000	chr17	73457325	73592708	Lclat1	+	135383	12011
chr17	73599003	73600858	1855	chr17	73457325	73592708	Lclat1	+	135383	6295
chr17	73607238	73608922	1684	chr17	73457325	73592708	Lclat1	+	135383	14530
chr17	73611686	73613488	1802	chr17	73457325	73592708	Lclat1	+	135383	18978
chr17	73621911	73623664	1753	chr17	73457325	73592708	Lclat1	+	135383	29203
chr17	73764073	73765611	1538	chr17	73655804	73748636	Capn13	-	92832	15437
chr17	74319122	74320258	1136	chr17	74233248	74299522	Xdh	-	66274	19600
chr17	76496353	76497353	1000	chr17	76510537	76510644	Y_RNA	-	107	13184
chr17	79498376	79500382	2006	chr17	79451246	79489583	Qpct	+	38337	8793
chr17	79853973	79855656	1683	chr17	79754039	79757362	Gm17315	+	3323	96611
chr17	80353252	80355053	1801	chr17	80247732	80295463	Atl2	-	47731	57789
chr17	80374037	80375798	1761	chr17	80428827	80461674	Hnrpll	-	32847	53029
chr17	80380136	80383012	2876	chr17	80428827	80461674	Hnrpll	-	32847	45815
chr17	80899838	80901309	1471	chr17	80793092	80879793	Sos1	-	86701	20045
chr17	82329223	82331216	1993	chr17	82593095	82593204	AC135509.1	+	109	261879
chr17	83557350	83558535	1185	chr17	83614623	83624410	Pkdcc	+	9787	56088
chr17	83675258	83676634	1376	chr17	83669311	83669445	SNORA31	+	134	5813
chr17	83711341	83712374	1033	chr17	83687886	83688368	Rpl21-ps7	+	482	22973
chr17	83737571	83739586	2015	chr17	83750271	83879701	Eml4	+	129430	10685
chr17	83944923	83946812	1889	chr17	83901259	83913673	Cox7a2l	-	12414	31250
chr17	84044575	84045575	1000	chr17	83985297	84031235	Kcng3	-	45938	13340
chr17	84053301	84054922	1621	chr17	83985297	84031235	Kcng3	-	45938	22066
chr17	84065356	84066365	1009	chr17	83985297	84031235	Kcng3	-	45938	34121
chr17	84260563	84261619	1056	chr17	84251015	84253733	C430042M11Rik	-	2718	6830
chr17	84317507	84318761	1254	chr17	84346928	84347036	5S_rRNA	+	108	28167
chr17	84334328	84336281	1953	chr17	84346928	84347036	5S_rRNA	+	108	10647
chr17	84403023	84404573	1550	chr17	84346928	84347036	5S_rRNA	+	108	55987
chr17	84427349	84428349	1000	chr17	84346928	84347036	5S_rRNA	+	108	80313
chr17	84462628	84464029	1401	chr17	84346928	84347036	5S_rRNA	+	108	115592
chr17	84482228	84483865	1637	chr17	84583271	84587287	Zfp36l2	-	4016	99406
chr17	84513265	84514265	1000	chr17	84583271	84587287	Zfp36l2	-	4016	69006
chr17	84515113	84521262	6149	chr17	84583271	84587287	Zfp36l2	-	4016	62009
chr17	84544290	84546319	2029	chr17	84583271	84587287	Zfp36l2	-	4016	36952
chr17	84561144	84562663	1519	chr17	84583271	84587287	Zfp36l2	-	4016	20608
chr17	85277078	85278221	1143	chr17	85354307	85357050	1110020A21Rik	-	2743	76086
chr17	86287532	86290085	2553	chr17	86384005	86544515	Srbd1	-	160510	93920
chr17	86297900	86299395	1495	chr17	86384005	86544515	Srbd1	-	160510	84610
chr17	87130948	87132328	1380	chr17	87153247	87232750	Epas1	+	79503	20919
chr17	87249341	87251233	1892	chr17	87153247	87232750	Epas1	+	79503	16591
chr17	87251289	87253432	2143	chr17	87153247	87232750	Epas1	+	79503	18539
chr17	87548639	87549639	1000	chr17	87507019	87536923	Socs5	+	29904	11716
chr17	87601285	87603697	2412	chr17	87583445	87583565	AC129309.1	-	120	17720
chr17	87609108	87611279	2171	chr17	87583445	87583565	AC129309.1	-	120	25543
chr17	87645410	87646410	1000	chr17	87653998	87665275	Mcfd2	-	11277	7588
chr17	87970357	87971357	1000	chr17	88035319	88050446	Epcam	+	15127	63962
chr17	88495654	88497474	1820	chr17	88390199	88464631	Fbxo11	-	74432	31023
chr17	88522053	88524029	1976	chr17	88530055	88530345	Gm4832	+	290	6026
chr17	88574780	88575780	1000	chr17	88545424	88559101	Gm17287	-	13677	15679
chr17	88589406	88590635	1229	chr17	88545424	88559101	Gm17287	-	13677	30305
chr17	88593875	88595579	1704	chr17	88545424	88559101	Gm17287	-	13677	34774
chr17	88650623	88651715	1092	chr17	88741728	88741822	U6	-	94	90013
chr17	88657329	88658416	1087	chr17	88741728	88741822	U6	-	94	83312
chr17	88673203	88675200	1997	chr17	88741728	88741822	U6	-	94	66528
chr17	88802152	88803555	1403	chr17	88792166	88792272	U6	-	106	9880
chr17	5798412	5799541	1129	chr17	5816200	5816640	Gm10231	-	440	16659
chr17	5802486	5803621	1135	chr17	5816200	5816640	Gm10231	-	440	12579
chr17	5803631	5806360	2729	chr17	5816200	5816640	Gm10231	-	440	9840
chr17	10286691	10287691	1000	chr17	10399336	10512245	Qk	-	112909	111645
chr17	19094027	19095027	1000	chr17	19051286	19085035	Vmn2r97	+	33749	8992
chr17	21611556	21613261	1705	chr17	21622141	21625839	Gm17372	-	3698	8880
chr17	21615029	21616174	1145	chr17	21622141	21625839	Gm17372	-	3698	5967
chr17	21653200	21654321	1121	chr17	21628220	21646629	Zfp53	+	18409	6571
chr17	24061593	24062623	1030	chr17	24054425	24056408	Dcpp3	+	1983	5185
chr17	29531017	29532130	1113	chr17	29497859	29516605	Fgd2	+	18746	14412
chr17	31883167	31884726	1559	chr17	31814878	31818667	Cryaa	+	3789	64500
chr17	31926058	31928719	2661	chr17	31981193	31992737	Sik1	-	11544	52474
chr17	31971966	31973048	1082	chr17	31981193	31992737	Sik1	-	11544	8145
chr17	32709646	32710646	1000	chr17	32673503	32688743	Cyp4f16	+	15240	20903
chr17	34307696	34309018	1322	chr17	34318932	34324697	Psmb9	-	5765	9914
chr17	43695700	43696700	1000	chr17	43705047	43749150	Pla2g7	+	44103	8347
chr17	44487342	44488342	1000	chr17	44325521	44417117	Clic5	+	91596	70225
chr17	44488629	44489629	1000	chr17	44325521	44417117	Clic5	+	91596	71512
chr17	48234009	48235077	1068	chr17	48226582	48227870	1700067P10Rik	+	1288	6139
chr17	50344403	50345445	1042	chr17	50131582	50329999	Rftn1	-	198417	14404
chr17	52301916	52303692	1776	chr17	52544362	52544442	AC121600.1	+	80	240670
chr17	57486784	57487898	1114	chr17	57498109	57622952	Emr1	+	124843	10211
chr17	71834983	71836088	1105	chr17	71845440	71876197	Ndc80	-	30757	9352
chr17	73310423	73311423	1000	chr17	73267645	73291282	Lbh	+	23637	19141
chr17	73316494	73317494	1000	chr17	73337138	73337244	U6	+	106	19644
chr17	73354243	73355318	1075	chr17	73337138	73337244	U6	+	106	16999
chr17	73765731	73767647	1916	chr17	73655804	73748636	Capn13	-	92832	17095
chr17	73790210	73791210	1000	chr17	73655804	73748636	Capn13	-	92832	41574
chr17	80898025	80899025	1000	chr17	80793092	80879793	Sos1	-	86701	18232
chr17	83676961	83677961	1000	chr17	83669311	83669445	SNORA31	+	134	7516
chr17	84456343	84457343	1000	chr17	84346928	84347036	5S_rRNA	+	108	109307
chr17	87858729	87859829	1100	chr17	87852563	87852696	SNORA17	-	133	6033
chr17	88001407	88002407	1000	chr17	88035319	88050446	Epcam	+	15127	32912
chr17	88511591	88512684	1093	chr17	88530055	88530345	Gm4832	+	290	17371
chr17	88654922	88655976	1054	chr17	88741728	88741822	U6	-	94	85752
chr17	88908338	88909430	1092	chr17	88840051	88889873	Foxn2	+	49822	18465
chr18	4238370	4239865	1495	chr18	4198214	4198967	Gm10557	-	753	39403
chr18	4278155	4279155	1000	chr18	4331325	4353013	Map3k8	-	21688	52170
chr18	4288980	4292851	3871	chr18	4331325	4353013	Map3k8	-	21688	38474
chr18	4294358	4295654	1296	chr18	4331325	4353013	Map3k8	-	21688	35671
chr18	4301414	4304864	3450	chr18	4331325	4353013	Map3k8	-	21688	26461
chr18	4310825	4314364	3539	chr18	4331325	4353013	Map3k8	-	21688	16961
chr18	5348094	5350029	1935	chr18	5210029	5334437	Zfp438	-	124408	13657
chr18	5805690	5807627	1937	chr18	5591870	5775741	Zeb1	+	183871	29949
chr18	5808239	5810358	2119	chr18	5591870	5775741	Zeb1	+	183871	32498
chr18	5818480	5820848	2368	chr18	5591870	5775741	Zeb1	+	183871	42739
chr18	5931691	5934099	2408	chr18	6024446	6136096	Arhgap12	-	111650	90347
chr18	5940643	5942866	2223	chr18	6024446	6136096	Arhgap12	-	111650	81580
chr18	5944156	5946013	1857	chr18	6024446	6136096	Arhgap12	-	111650	78433
chr18	5989416	5990869	1453	chr18	6024446	6136096	Arhgap12	-	111650	33577
chr18	6016687	6018315	1628	chr18	6024446	6136096	Arhgap12	-	111650	6131
chr18	6141643	6143658	2015	chr18	6024446	6136096	Arhgap12	-	111650	5547
chr18	6144386	6145781	1395	chr18	6024446	6136096	Arhgap12	-	111650	8290
chr18	6279986	6282386	2400	chr18	6201000	6242172	Kif5b	-	41172	37814
chr18	6285231	6286231	1000	chr18	6201000	6242172	Kif5b	-	41172	43059
chr18	6289890	6290890	1000	chr18	6332588	6333062	Rpl27-ps3	+	474	41698
chr18	6393938	6394938	1000	chr18	6435949	6516106	Epc1	-	80157	41011
chr18	7692689	7693736	1047	chr18	7347960	7626861	Mpp7	-	278901	65828
chr18	10051708	10053016	1308	chr18	9995430	10045117	Usp14	-	49687	6591
chr18	10893938	10895072	1134	chr18	10725546	10818702	Mib1	+	93156	75236
chr18	13113881	13114962	1081	chr18	13120008	13120314	7SK	+	306	5046
chr18	15372461	15373507	1046	chr18	15127194	15309955	Kctd1	-	182761	62506
chr18	20942576	20944401	1825	chr18	20975725	21054579	Trappc8	-	78854	31324
chr18	21832473	21835480	3007	chr18	21809949	21814606	4930426D05Rik	+	4657	17867
chr18	24069917	24076025	6108	chr18	23910834	24052362	Mapre2	+	141528	17555
chr18	24079378	24080378	1000	chr18	24103451	24104135	Rpl19-ps7	+	684	23073
chr18	24093612	24094612	1000	chr18	24103451	24104135	Rpl19-ps7	+	684	8839
chr18	24248852	24251274	2422	chr18	24263258	24280454	Ino80c	-	17196	11984
chr18	32439919	32441316	1397	chr18	32399954	32429805	Ercc3	+	29851	10114
chr18	32728182	32730160	1978	chr18	32687976	32719688	Gypc	-	31712	8494
chr18	34262340	34263360	1020	chr18	34253099	34253224	SNORA17	+	125	9116
chr18	35046407	35049392	2985	chr18	35062446	35091657	Etf1	-	29211	13054
chr18	35252811	35254157	1346	chr18	35278542	35414427	Ctnna1	+	135885	24385
chr18	35906055	35907188	1133	chr18	35893332	35900208	Tmem173	-	6876	5847
chr18	35911198	35912236	1038	chr18	35893332	35900208	Tmem173	-	6876	10990
chr18	36032771	36034025	1254	chr18	35989472	36021341	Cxxc5	+	31869	11430
chr18	36047265	36050360	3095	chr18	35989472	36021341	Cxxc5	+	31869	25924
chr18	36069284	36070866	1582	chr18	36112478	36112561	AC141471.1	+	83	41612
chr18	36072243	36073847	1604	chr18	36112478	36112561	AC141471.1	+	83	38631
chr18	36086641	36088536	1895	chr18	36112478	36112561	AC141471.1	+	83	23942
chr18	36088546	36090972	2426	chr18	36112478	36112561	AC141471.1	+	83	21506
chr18	36092258	36093704	1446	chr18	36112478	36112561	AC141471.1	+	83	18774
chr18	36096989	36098083	1094	chr18	36112478	36112561	AC141471.1	+	83	14395
chr18	36098862	36099925	1063	chr18	36112478	36112561	AC141471.1	+	83	12553
chr18	36101178	36102771	1593	chr18	36112478	36112561	AC141471.1	+	83	9707
chr18	36867464	36869617	2153	chr18	36844577	36855579	E230025N22Rik	-	11002	11885
chr18	38173308	38174308	1000	chr18	38132278	38157228	Arap3	-	24950	16080
chr18	38507827	38510657	2830	chr18	38516232	38516328	5S_rRNA	+	96	5575
chr18	38523932	38526378	2446	chr18	38516232	38516328	5S_rRNA	+	96	7604
chr18	38526743	38528404	1661	chr18	38516232	38516328	5S_rRNA	+	96	10415
chr18	38531077	38532432	1355	chr18	38516232	38516328	5S_rRNA	+	96	14749
chr18	38565545	38567861	2316	chr18	38578629	38624053	Ndfip1	+	45424	10768
chr18	38643062	38644366	1304	chr18	38627521	38627587	AC134576.1	-	66	15475
chr18	39676610	39679940	3330	chr18	39570199	39650955	Nr3c1	-	80756	25655
chr18	39809591	39810591	1000	chr18	39933151	39935736	Pabpc2	+	2585	122560
chr18	40030885	40031885	1000	chr18	39933151	39935736	Pabpc2	+	2585	95149
chr18	42020537	42021614	1077	chr18	42035350	42110848	Prelid2	-	75498	13736
chr18	46308598	46310178	1580	chr18	46324956	46372261	Trim36	-	47305	14778
chr18	46312742	46313742	1000	chr18	46324956	46372261	Trim36	-	47305	11214
chr18	46606449	46607449	1000	chr18	46624588	46625470	Mospd4	-	882	17139
chr18	49929558	49930558	1000	chr18	49915448	49916843	Gm16283	+	1395	12715
chr18	49930971	49932473	1502	chr18	49915448	49916843	Gm16283	+	1395	14128
chr18	49936322	49938575	2253	chr18	49915448	49916843	Gm16283	+	1395	19479
chr18	49942344	49945216	2872	chr18	49915448	49916843	Gm16283	+	1395	25501
chr18	50271958	50272958	1000	chr18	50139081	50266827	Tnfaip8	+	127746	5131
chr18	50473099	50474741	1642	chr18	50438023	50442673	Fam170a	+	4650	30426
chr18	53266407	53269002	2595	chr18	53336019	53380514	Snx2	+	44495	67017
chr18	53386364	53388107	1743	chr18	53336019	53380514	Snx2	+	44495	5850
chr18	54980847	54984325	3478	chr18	55047699	55152245	Zfp608	-	104546	63374
chr18	55005174	55007477	2303	chr18	55047699	55152245	Zfp608	-	104546	40222
chr18	55019133	55020874	1741	chr18	55047699	55152245	Zfp608	-	104546	26825
chr18	55038374	55039374	1000	chr18	55047699	55152245	Zfp608	-	104546	8325
chr18	55305968	55308694	2726	chr18	55339494	55339573	U6	+	79	30800
chr18	55362498	55364298	1800	chr18	55339494	55339573	U6	+	79	22925
chr18	55707694	55709382	1688	chr18	55782287	55782574	AC149599.1	-	287	72905
chr18	56844153	56845371	1218	chr18	56867467	56913078	Lmnb1	+	45611	22096
chr18	57158042	57159314	1272	chr18	57115487	57135022	C330018D20Rik	-	19535	23020
chr18	57244662	57246179	1517	chr18	57292744	57457121	Megf10	+	164377	46565
chr18	57466476	57468299	1823	chr18	57292744	57457121	Megf10	+	164377	9355
chr18	57945583	57946583	1000	chr18	57693434	57890719	1700011I03Rik	+	197285	54864
chr18	57958370	57959370	1000	chr18	57693434	57890719	1700011I03Rik	+	197285	67651
chr18	57995640	57997513	1873	chr18	58038332	58106475	Slc12a2	+	68143	40819
chr18	58017303	58018303	1000	chr18	58038332	58106475	Slc12a2	+	68143	20029
chr18	60946566	60949742	3176	chr18	60938637	60939048	Gm8731	-	411	7518
chr18	61640480	61642378	1898	chr18	61653448	61696190	Arhgef37	-	42742	11070
chr18	62196287	62198566	2279	chr18	62112729	62184019	Sh3tc2	+	71290	12268
chr18	62200441	62201692	1251	chr18	62112729	62184019	Sh3tc2	+	71290	16422
chr18	62228132	62229132	1000	chr18	62112729	62184019	Sh3tc2	+	71290	44113
chr18	62270110	62271110	1000	chr18	62337471	62339613	Adrb2	-	2142	66361
chr18	62320513	62324770	4257	chr18	62337471	62339613	Adrb2	-	2142	12701
chr18	62327990	62329859	1869	chr18	62337471	62339613	Adrb2	-	2142	7612
chr18	62350982	62352912	1930	chr18	62339780	62344059	Gm9949	+	4279	6923
chr18	65649403	65650515	1112	chr18	65643292	65643362	AC102240.2	-	70	6041
chr18	66635315	66638184	2869	chr18	66618258	66625204	Pmaip1	+	6946	10111
chr18	66660876	66662808	1932	chr18	66618258	66625204	Pmaip1	+	6946	35672
chr18	66745905	66747604	1699	chr18	66709589	66709699	SNORA17	-	110	36206
chr18	68056379	68058399	2020	chr18	67959761	68044822	Cep192	+	85061	11557
chr18	68634145	68635145	1000	chr18	68566561	68588905	Mc2r	-	22344	45240
chr18	68925102	68926275	1173	chr18	69104287	69109795	4930546C10Rik	-	5508	178012
chr18	68988377	68990006	1629	chr18	69104287	69109795	4930546C10Rik	-	5508	114281
chr18	68990695	68993074	2379	chr18	69104287	69109795	4930546C10Rik	-	5508	111213
chr18	69086132	69087132	1000	chr18	69104287	69109795	4930546C10Rik	-	5508	17155
chr18	69087346	69089648	2302	chr18	69104287	69109795	4930546C10Rik	-	5508	14639
chr18	69243515	69246939	3424	chr18	69333641	69333774	5S_rRNA	-	133	86702
chr18	70595100	70596100	1000	chr18	70612794	70632134	4930503L19Rik	-	19340	16694
chr18	70802881	70804586	1705	chr18	70727843	70785785	Mbd2	+	57942	17096
chr18	73701054	73702452	1398	chr18	73693057	73693204	n-R5-8s1	-	147	7850
chr18	74388781	74389938	1157	chr18	74375785	74381145	Cxxc1	+	5360	7636
chr18	74526262	74528177	1915	chr18	74442744	74519640	Ccdc11	+	76896	6622
chr18	75465886	75467546	1660	chr18	75178426	75446620	Dym	+	268194	19266
chr18	75501946	75503430	1484	chr18	75524986	75526742	Gm20544	-	1756	21556
chr18	75577991	75580098	2107	chr18	75590878	75857350	Ctif	-	266472	10780
chr18	78642935	78644448	1513	chr18	78730197	78730303	U6	+	106	85749
chr18	78676514	78677666	1152	chr18	78730197	78730303	U6	+	106	52531
chr18	79442307	79444800	2493	chr18	78947119	79306130	Setbp1	-	359011	136177
chr18	80674293	80675761	1468	chr18	80604698	80666434	Ctdp1	-	61736	7859
chr18	80679668	80681394	1726	chr18	80604698	80666434	Ctdp1	-	61736	13234
chr18	80742482	80743958	1476	chr18	80802944	80909810	Nfatc1	-	106866	58986
chr18	80750566	80752625	2059	chr18	80802944	80909810	Nfatc1	-	106866	50319
chr18	80920632	80921805	1173	chr18	80931816	81130797	Atp9b	-	198981	10011
chr18	81623311	81624427	1116	chr18	81223512	81223629	U6	+	117	399682
chr18	81626479	81627610	1131	chr18	81223512	81223629	U6	+	117	402850
chr18	82633042	82634579	1537	chr18	82644538	82755029	Mbp	+	110491	9959
chr18	82951509	82953513	2004	chr18	82889673	82889732	Mir5112	+	59	61777
chr18	90748428	90749907	1479	chr18	90761007	90761174	Gm17635	+	167	11100
chr18	90754903	90755903	1000	chr18	90761007	90761174	Gm17635	+	167	5104
chr18	4265912	4266912	1000	chr18	4331325	4353013	Map3k8	-	21688	64413
chr18	4279303	4281518	2215	chr18	4331325	4353013	Map3k8	-	21688	49807
chr18	4314599	4316357	1758	chr18	4331325	4353013	Map3k8	-	21688	14968
chr18	5124911	5125911	1000	chr18	4920538	5119297	Svil	+	198759	5614
chr18	14771934	14773231	1297	chr18	14782707	14841423	Ss18	-	58716	9476
chr18	15353323	15354502	1179	chr18	15127194	15309955	Kctd1	-	182761	43368
chr18	17165125	17166125	1000	chr18	17177560	17296068	1700001G01Rik	+	118508	11435
chr18	20955597	20956663	1066	chr18	20975725	21054579	Trappc8	-	78854	19062
chr18	21153599	21154599	1000	chr18	21159842	21186724	Rnf138	+	26882	5243
chr18	21886793	21887898	1105	chr18	21809949	21814606	4930426D05Rik	+	4657	72187
chr18	24201175	24202175	1000	chr18	24168203	24179311	Zfp191	-	11108	21864
chr18	34268259	34269259	1000	chr18	34253099	34253224	SNORA17	+	125	15035
chr18	35973170	35974170	1000	chr18	35931213	35966826	Ube2d2	+	35613	6344
chr18	36078579	36080314	1735	chr18	36112478	36112561	AC141471.1	+	83	32164
chr18	39960244	39961595	1351	chr18	39933151	39935736	Pabpc2	+	2585	24508
chr18	46251714	46252714	1000	chr18	46324956	46372261	Trim36	-	47305	72242
chr18	54991811	54992811	1000	chr18	55047699	55152245	Zfp608	-	104546	54888
chr18	60951542	60952736	1194	chr18	60963502	60972300	Cd74	+	8798	10766
chr18	61250501	61251880	1379	chr18	61204804	61244715	Pdgfrb	+	39911	5786
chr18	65575370	65578418	3048	chr18	65587123	65587464	AC102240.1	+	341	8705
chr18	66084674	66085674	1000	chr18	66094293	66098743	Rax	-	4450	8619
chr18	66596393	66597481	1088	chr18	66618258	66625204	Pmaip1	+	6946	20777
chr18	66607327	66610683	3356	chr18	66618258	66625204	Pmaip1	+	6946	7575
chr18	73921799	73922911	1112	chr18	73929694	73975046	Me2	-	45352	6783
chr18	73994708	73996479	1771	chr18	73929694	73975046	Me2	-	45352	19662
chr18	79435514	79436514	1000	chr18	78947119	79306130	Setbp1	-	359011	129384
chr18	79453611	79454611	1000	chr18	78947119	79306130	Setbp1	-	359011	147481
chr18	80365973	80367058	1085	chr18	80323077	80348221	Adnp2	-	25144	17752
chr18	82995061	82996061	1000	chr18	83025286	83039996	3010027C24Rik	+	14710	29225
chr19	5529262	5530262	1000	chr19	5495278	5510489	Snx32	-	15211	18773
chr19	5786316	5788595	2279	chr19	5795690	5802671	Malat1	-	6981	7095
chr19	5817322	5819010	1688	chr19	5824708	5845478	Neat1	-	20770	5698
chr19	5929562	5931075	1513	chr19	5940543	5964206	Pola2	-	23663	9468
chr19	6943389	6946926	3537	chr19	6919113	6932701	Ccdc88b	-	13588	10688
chr19	6969500	6971002	1502	chr19	6981187	6984596	Prdx5	-	3409	10185
chr19	8093839	8094892	1053	chr19	8136699	8206472	Slc22a28	-	69773	41807
chr19	8120499	8122622	2123	chr19	8136699	8206472	Slc22a28	-	69773	14077
chr19	8592056	8593913	1857	chr19	8662897	8663686	Gm6425	-	789	68984
chr19	9174297	9176148	1851	chr19	9184358	9210126	Asrgl1	-	25768	8210
chr19	9383333	9385765	2432	chr19	9357869	9358654	Pcna-ps2	+	785	24679
chr19	9991630	9992933	1303	chr19	9982648	9982768	AC132253.2	+	120	8862
chr19	10005575	10006828	1253	chr19	9982648	9982768	AC132253.2	+	120	22807
chr19	10012400	10013788	1388	chr19	9982648	9982768	AC132253.2	+	120	29632
chr19	10016098	10019575	3477	chr19	9982648	9982768	AC132253.2	+	120	33330
chr19	10020270	10021417	1147	chr19	10057193	10059582	Fth1	+	2389	35776
chr19	10028871	10029871	1000	chr19	10057193	10059582	Fth1	+	2389	27322
chr19	10245576	10248928	3352	chr19	10257378	10271360	Fads1	+	13982	8450
chr19	10425967	10427324	1357	chr19	10463580	10527671	Syt7	+	64091	36256
chr19	11427834	11435494	7660	chr19	11395529	11410636	Ms4a7	-	15107	17198
chr19	11435950	11436976	1026	chr19	11395529	11410636	Ms4a7	-	15107	25314
chr19	11437772	11438975	1203	chr19	11395529	11410636	Ms4a7	-	15107	27136
chr19	11461525	11463340	1815	chr19	11479260	11501736	Ms4a4c	+	22476	15920
chr19	11463442	11464759	1317	chr19	11479260	11501736	Ms4a4c	+	22476	14501
chr19	11469278	11470790	1512	chr19	11479260	11501736	Ms4a4c	+	22476	8470
chr19	12083379	12085353	1974	chr19	12040334	12068595	Osbp	+	28261	14784
chr19	12592146	12593220	1074	chr19	12540831	12576486	Dtx4	-	35655	15660
chr19	14198139	14199848	1709	chr19	13993432	13994534	Olfr1505	+	1102	203605
chr19	14227690	14228690	1000	chr19	13993432	13994534	Olfr1505	+	1102	233156
chr19	14271607	14273481	1874	chr19	14522562	14672473	Tle4	-	149911	249081
chr19	14298267	14300383	2116	chr19	14522562	14672473	Tle4	-	149911	222179
chr19	14315922	14316922	1000	chr19	14522562	14672473	Tle4	-	149911	205640
chr19	14317224	14319484	2260	chr19	14522562	14672473	Tle4	-	149911	203078
chr19	14325095	14328387	3292	chr19	14522562	14672473	Tle4	-	149911	194175
chr19	14330447	14335449	5002	chr19	14522562	14672473	Tle4	-	149911	187113
chr19	14414636	14419336	4700	chr19	14522562	14672473	Tle4	-	149911	103226
chr19	14425433	14426515	1082	chr19	14522562	14672473	Tle4	-	149911	96047
chr19	14433182	14436185	3003	chr19	14522562	14672473	Tle4	-	149911	86377
chr19	14445111	14447049	1938	chr19	14522562	14672473	Tle4	-	149911	75513
chr19	14461906	14464198	2292	chr19	14522562	14672473	Tle4	-	149911	58364
chr19	14693437	14697341	3904	chr19	14522562	14672473	Tle4	-	149911	20964
chr19	14766190	14767190	1000	chr19	14792848	14792970	U4	-	122	25658
chr19	16138212	16139308	1096	chr19	16099941	16100210	Rpl37-ps1	+	269	38002
chr19	16160505	16161505	1000	chr19	16207321	16461953	Gnaq	+	254632	45816
chr19	16481582	16483237	1655	chr19	16207321	16461953	Gnaq	+	254632	19629
chr19	16863727	16865846	2119	chr19	16855037	16855593	Gm9806	+	556	8134
chr19	17329794	17330875	1081	chr19	17030608	17298422	Prune2	+	267814	31372
chr19	17337487	17341156	3669	chr19	17030608	17298422	Prune2	+	267814	39065
chr19	17346959	17347959	1000	chr19	17030608	17298422	Prune2	+	267814	48537
chr19	18738284	18739284	1000	chr19	18745270	18779278	2410127L17Rik	+	34008	5986
chr19	21110809	21111948	1139	chr19	20857948	21028692	Tmc1	-	170744	82117
chr19	21218583	21220064	1481	chr19	21346768	21356779	Zfand5	+	10011	126704
chr19	21645059	21646559	1500	chr19	21630164	21632339	Gm3443	+	2175	12720
chr19	21657272	21659347	2075	chr19	21671803	21727281	1110059E24Rik	-	55478	12456
chr19	21659374	21660424	1050	chr19	21671803	21727281	1110059E24Rik	-	55478	11379
chr19	21801879	21804064	2185	chr19	21727799	21760127	Fam108b	+	32328	41752
chr19	21811354	21812524	1170	chr19	21852832	21932817	Tmem2	+	79985	40308
chr19	21986866	21988643	1777	chr19	22012569	22012874	Gm5514	+	305	23926
chr19	22020425	22021425	1000	chr19	22012569	22012874	Gm5514	+	305	7551
chr19	22021718	22023605	1887	chr19	22012569	22012874	Gm5514	+	305	8844
chr19	24719820	24721662	1842	chr19	24748498	24754151	E030010A14Rik	+	5653	26836
chr19	24730553	24732463	1910	chr19	24748498	24754151	E030010A14Rik	+	5653	16035
chr19	26919621	26920673	1052	chr19	26843291	26898397	4931403E22Rik	-	55106	21224
chr19	26992489	26994747	2258	chr19	26960415	26963129	Gm815	+	2714	29360
chr19	27033136	27034555	1419	chr19	26960415	26963129	Gm815	+	2714	70007
chr19	27383482	27385391	1909	chr19	27397078	27411669	Kcnv2	+	14591	11687
chr19	29138285	29139617	1332	chr19	29095323	29122451	Ak3	-	27128	15834
chr19	29268123	29269123	1000	chr19	29234608	29235255	Gm5518	+	647	32868
chr19	29283945	29285243	1298	chr19	29326318	29387570	Jak2	+	61252	41075
chr19	29302010	29303873	1863	chr19	29326318	29387570	Jak2	+	61252	22445
chr19	29310494	29312079	1585	chr19	29326318	29387570	Jak2	+	61252	14239
chr19	29313303	29314303	1000	chr19	29326318	29387570	Jak2	+	61252	12015
chr19	32045870	32046870	1000	chr19	32059144	32135959	Asah2	-	76815	12274
chr19	32182021	32183059	1038	chr19	32197217	32464204	Sgms1	-	266987	14158
chr19	32185422	32188414	2992	chr19	32197217	32464204	Sgms1	-	266987	8803
chr19	32905675	32907819	2144	chr19	32831987	32900650	Pten	+	68663	5025
chr19	32977227	32980019	2792	chr19	33044440	33044798	7SK	-	358	64421
chr19	32986458	32988625	2167	chr19	33044440	33044798	7SK	-	358	55815
chr19	33013762	33015037	1275	chr19	33044440	33044798	7SK	-	358	29403
chr19	33026329	33028410	2081	chr19	33044440	33044798	7SK	-	358	16030
chr19	33030932	33031995	1063	chr19	33044440	33044798	7SK	-	358	12445
chr19	33033992	33035756	1764	chr19	33044440	33044798	7SK	-	358	8684
chr19	33109243	33111313	2070	chr19	33044440	33044798	7SK	-	358	64445
chr19	33115325	33118403	3078	chr19	33044440	33044798	7SK	-	358	70527
chr19	33155406	33156916	1510	chr19	33212237	33466785	Rnls	-	254548	55321
chr19	33193584	33195566	1982	chr19	33212237	33466785	Rnls	-	254548	16671
chr19	33196021	33198889	2868	chr19	33212237	33466785	Rnls	-	254548	13348
chr19	35826445	35827653	1208	chr19	35834423	35834555	SNORA17	-	132	6770
chr19	35947523	35950042	2519	chr19	36033224	36131997	Htr7	-	98773	83182
chr19	35951586	35952586	1000	chr19	36033224	36131997	Htr7	-	98773	80638
chr19	35957390	35959049	1659	chr19	36033224	36131997	Htr7	-	98773	74175
chr19	36278874	36280816	1942	chr19	36186455	36194334	Ankrd1	-	7879	84540
chr19	36295486	36297869	2383	chr19	36186455	36194334	Ankrd1	-	7879	101152
chr19	36889489	36890918	1429	chr19	36908722	36967967	Tnks2	+	59245	17804
chr19	36978251	36979251	1000	chr19	36908722	36967967	Tnks2	+	59245	10284
chr19	37444479	37445710	1231	chr19	37450893	37496349	Kif11	+	45456	5183
chr19	37522221	37524184	1963	chr19	37507377	37515218	Hhex	+	7841	7003
chr19	37545494	37547262	1768	chr19	37538236	37538341	U6	+	105	7153
chr19	37562971	37563971	1000	chr19	37538236	37538341	U6	+	105	24630
chr19	37567576	37568576	1000	chr19	37538236	37538341	U6	+	105	29235
chr19	37569735	37570955	1220	chr19	37538236	37538341	U6	+	105	31394
chr19	37588696	37590711	2015	chr19	37624908	37757735	Exoc6	+	132827	34197
chr19	37597467	37598705	1238	chr19	37624908	37757735	Exoc6	+	132827	26203
chr19	37601169	37604078	2909	chr19	37624908	37757735	Exoc6	+	132827	20830
chr19	37609211	37610507	1296	chr19	37624908	37757735	Exoc6	+	132827	14401
chr19	40835713	40837359	1646	chr19	40686856	40816092	Entpd1	+	129236	19621
chr19	41082409	41084152	1743	chr19	41003417	41069025	Blnk	-	65608	13384
chr19	41087664	41091326	3662	chr19	41103765	41134013	Dntt	+	30248	12439
chr19	41464640	41466575	1935	chr19	41346863	41459586	Pik3ap1	-	112723	5054
chr19	41471811	41472989	1178	chr19	41346863	41459586	Pik3ap1	-	112723	12225
chr19	41476579	41477800	1221	chr19	41346863	41459586	Pik3ap1	-	112723	16993
chr19	41516279	41517578	1299	chr19	41534303	41535208	Gm9788	+	905	16725
chr19	41892560	41893641	1081	chr19	41904658	41905299	Frat1	+	641	11017
chr19	42231853	42233030	1177	chr19	42238441	42269080	Zfyve27	+	30639	5411
chr19	43704500	43706369	1869	chr19	43696936	43697050	AC138790.1	+	114	7450
chr19	44014005	44015130	1125	chr19	44006806	44006922	n-R5s21	+	116	7083
chr19	44326088	44327116	1028	chr19	44277759	44318506	Scd3	+	40747	7582
chr19	44327977	44329150	1173	chr19	44277759	44318506	Scd3	+	40747	9471
chr19	44330831	44332860	2029	chr19	44277759	44318506	Scd3	+	40747	12325
chr19	44337921	44342330	4409	chr19	44359725	44359780	AC123853.1	-	55	17395
chr19	44388419	44389523	1104	chr19	44368166	44381354	Scd2	+	13188	7065
chr19	44447422	44448422	1000	chr19	44468941	44482199	Scd1	-	13258	20519
chr19	44449217	44452073	2856	chr19	44468941	44482199	Scd1	-	13258	16868
chr19	44455373	44460031	4658	chr19	44468941	44482199	Scd1	-	13258	8910
chr19	44535951	44536951	1000	chr19	44567962	44588763	Wnt8b	+	20801	31011
chr19	44800294	44801294	1000	chr19	44830539	44912758	Pax2	+	82219	29245
chr19	45250023	45251754	1731	chr19	45228547	45233794	Gm20424	-	5247	16229
chr19	46569172	46570482	1310	chr19	46576138	46590934	Trim8	+	14796	5656
chr19	46596802	46598355	1553	chr19	46576138	46590934	Trim8	+	14796	5868
chr19	53193167	53194857	1690	chr19	53214935	53321889	Add3	+	106954	20078
chr19	53358319	53359480	1161	chr19	53384996	53450300	Mxi1	+	65304	25516
chr19	53471835	53472835	1000	chr19	53453704	53465063	Smndc1	-	11359	6772
chr19	53479442	53481398	1956	chr19	53453704	53465063	Smndc1	-	11359	14379
chr19	53484116	53485366	1250	chr19	53453704	53465063	Smndc1	-	11359	19053
chr19	53495308	53496760	1452	chr19	53515702	53539286	5830416P10Rik	-	23584	18942
chr19	53553350	53555293	1943	chr19	53515702	53539286	5830416P10Rik	-	23584	14064
chr19	53576622	53578039	1417	chr19	53603599	53616921	Dusp5	+	13322	25560
chr19	53642265	53643265	1000	chr19	53662694	53663558	Nutf2-ps1	-	864	19429
chr19	53646024	53647024	1000	chr19	53662694	53663558	Nutf2-ps1	-	864	15670
chr19	56846183	56847616	1433	chr19	56861971	56896680	A630007B06Rik	-	34709	14355
chr19	58703207	58705023	1816	chr19	58744855	58756276	Pnlip	+	11421	39832
chr19	60258043	60259356	1313	chr19	60274489	60302600	D19Ertd737e	-	28111	15133
chr19	60360151	60362034	1883	chr19	60302237	60303581	4933412A08Rik	+	1344	56570
chr19	60756688	60758391	1703	chr19	60831890	60835816	Nanos1	+	3926	73499
chr19	60958552	60959933	1381	chr19	60965652	61168456	Grk5	+	202804	5719
chr19	61227253	61229122	1869	chr19	61129743	61216743	5830428H23Rik	-	87000	10510
chr19	61275163	61276163	1000	chr19	61259793	61259858	Gm6020	+	65	15305
chr19	61320025	61321090	1065	chr19	61308686	61308793	Gm4242	-	107	11232
chr19	3083120	3084152	1032	chr19	3136984	3137090	U6	-	106	52832
chr19	9390616	9391743	1127	chr19	9357869	9358654	Pcna-ps2	+	785	31962
chr19	10049387	10050387	1000	chr19	10057193	10059582	Fth1	+	2389	6806
chr19	12076766	12077766	1000	chr19	12040334	12068595	Osbp	+	28261	8171
chr19	12079409	12083099	3690	chr19	12040334	12068595	Osbp	+	28261	10814
chr19	12085755	12087952	2197	chr19	12040334	12068595	Osbp	+	28261	17160
chr19	15912472	15913472	1000	chr19	15979168	16021827	Psat1	-	42659	65696
chr19	16090618	16091618	1000	chr19	16059580	16085402	C130060C02Rik	+	25822	5216
chr19	17325571	17326869	1298	chr19	17030608	17298422	Prune2	+	267814	27149
chr19	21152417	21153417	1000	chr19	20857948	21028692	Tmc1	-	170744	123725
chr19	21250453	21251453	1000	chr19	21346768	21356779	Zfand5	+	10011	95315
chr19	21581764	21582764	1000	chr19	21465797	21547935	Gda	-	82138	33829
chr19	21660616	21661616	1000	chr19	21671803	21727281	1110059E24Rik	-	55478	10187
chr19	21788005	21789289	1284	chr19	21727799	21760127	Fam108b	+	32328	27878
chr19	24690312	24691312	1000	chr19	24748498	24754151	E030010A14Rik	+	5653	57186
chr19	27040312	27041312	1000	chr19	26960415	26963129	Gm815	+	2714	77183
chr19	28847535	28848535	1000	chr19	28837651	28837920	Gm6788	-	269	9615
chr19	29141537	29142606	1069	chr19	29095323	29122451	Ak3	-	27128	19086
chr19	32669936	32670949	1013	chr19	32694495	32741677	Papss2	+	47182	23546
chr19	33010046	33011384	1338	chr19	33044440	33044798	7SK	-	358	33056
chr19	33127675	33128744	1069	chr19	33044440	33044798	7SK	-	358	82877
chr19	33175725	33177401	1676	chr19	33212237	33466785	Rnls	-	254548	34836
chr19	35201092	35202246	1154	chr19	35277725	35277856	SNORA17	+	131	75479
chr19	35950320	35951487	1167	chr19	36033224	36131997	Htr7	-	98773	81737
chr19	36299211	36300359	1148	chr19	36186455	36194334	Ankrd1	-	7879	104877
chr19	36422632	36423774	1142	chr19	36453557	36530682	Pcgf5	+	77125	29783
chr19	37568608	37569658	1050	chr19	37538236	37538341	U6	+	105	30267
chr19	40968867	40970053	1186	chr19	40985983	40992437	Zfp518a	+	6454	15930
chr19	44438024	44439339	1315	chr19	44407582	44421233	Scd4	+	13651	16791
chr19	44452542	44454717	2175	chr19	44468941	44482199	Scd1	-	13258	14224
chr19	45381915	45383047	1132	chr19	45438224	45607831	Btrc	+	169607	55177
chr19	46598558	46599707	1149	chr19	46605599	46647575	Arl3	-	41976	5892
chr19	53498135	53499484	1349	chr19	53515702	53539286	5830416P10Rik	-	23584	16218
chr19	53508467	53509492	1025	chr19	53515702	53539286	5830416P10Rik	-	23584	6210
chr19	53594372	53595386	1014	chr19	53603599	53616921	Dusp5	+	13322	8213
chr19	53631624	53632624	1000	chr19	53603599	53616921	Dusp5	+	13322	14703
chr19	57486144	57487144	1000	chr19	57435499	57464084	Fam160b1	+	28585	22060
chr19	60741764	60742764	1000	chr19	60600599	60656926	2700078E11Rik	-	56327	84838
chr19	61341119	61342712	1593	chr19	61308686	61308793	Gm4242	-	107	32326
chr2	3716541	3717800	1259	chr2	3531030	3699414	Fam107b	+	168384	17127
chr2	4740672	4742490	1818	chr2	4755182	4755658	Gm13176	-	476	12692
chr2	5660826	5663066	2240	chr2	5214503	5635561	Camk1d	-	421058	25265
chr2	5690994	5692745	1751	chr2	5715340	5766210	Cdc123	-	50870	22595
chr2	7191685	7192685	1000	chr2	7271724	7271820	U6	+	96	79039
chr2	10235711	10238259	2548	chr2	10260910	10295668	Gm13261	-	34758	22651
chr2	10243710	10244710	1000	chr2	10260910	10295668	Gm13261	-	34758	16200
chr2	11296552	11297594	1042	chr2	11306630	11308691	Gm13291	+	2061	9036
chr2	11298474	11299782	1308	chr2	11306630	11308691	Gm13291	+	2061	6848
chr2	11350674	11351674	1000	chr2	11341849	11342863	Gm13296	+	1014	7811
chr2	11362573	11364481	1908	chr2	11341849	11342863	Gm13296	+	1014	19710
chr2	11379581	11380581	1000	chr2	11393057	11423728	Pfkfb3	-	30671	12476
chr2	11442470	11443568	1098	chr2	11393057	11423728	Pfkfb3	-	30671	18742
chr2	11445084	11446084	1000	chr2	11393057	11423728	Pfkfb3	-	30671	21356
chr2	11456444	11457933	1489	chr2	11393057	11423728	Pfkfb3	-	30671	32716
chr2	11473286	11475859	2573	chr2	11507066	11525780	Rbm17	-	18714	31207
chr2	18528661	18531428	2767	chr2	18563413	18563729	Gm13355	-	316	31985
chr2	18584631	18585770	1139	chr2	18594011	18597858	Commd3	+	3847	8241
chr2	18742696	18743906	1210	chr2	18763882	18919753	Pip4k2a	-	155871	19976
chr2	19248852	19250863	2011	chr2	19265944	19272677	4930447M23Rik	+	6733	15081
chr2	19591895	19593244	1349	chr2	19598338	19607784	Gm13346	-	9446	5094
chr2	24166485	24167625	1140	chr2	24177944	24178476	Gm13411	+	532	10319
chr2	24214831	24216030	1199	chr2	24223100	24264702	Psd4	+	41602	7070
chr2	24970663	24972915	2252	chr2	24978123	25000916	Gm13387	-	22793	5208
chr2	25018444	25019444	1000	chr2	25036278	25038850	Nrarp	+	2572	16834
chr2	25022983	25023992	1009	chr2	25036278	25038850	Nrarp	+	2572	12286
chr2	26406801	26407801	1000	chr2	26414145	26414713	Gm13358	+	568	6344
chr2	27408214	27409271	1057	chr2	27395946	27398882	Gm13421	+	2936	9332
chr2	28097204	28098933	1729	chr2	28048512	28086256	Olfm1	+	37744	10948
chr2	28099532	28101236	1704	chr2	28048512	28086256	Olfm1	+	37744	13276
chr2	28252475	28254471	1996	chr2	28296182	28296262	AL772249.1	-	80	41711
chr2	28955868	28957074	1206	chr2	28944186	28950021	Gm13393	+	5835	5847
chr2	30318223	30320595	2372	chr2	30328168	30329719	Ier5l	-	1551	7573
chr2	30351209	30352410	1201	chr2	30328168	30329719	Ier5l	-	1551	21490
chr2	30403143	30404143	1000	chr2	30390249	30394542	Gm14487	+	4293	8601
chr2	30555178	30556275	1097	chr2	30485175	30544730	9330198N18Rik	+	59555	10448
chr2	31094038	31095766	1728	chr2	31101343	31151509	Ncs1	+	50166	5577
chr2	31992708	31994536	1828	chr2	32006602	32090057	Prrc2b	+	83455	12066
chr2	31995316	31996316	1000	chr2	32006602	32090057	Prrc2b	+	83455	10286
chr2	32348815	32349815	1000	chr2	32380551	32383510	Gm13412	+	2959	30736
chr2	32350048	32351584	1536	chr2	32380551	32383510	Gm13412	+	2959	28967
chr2	33763094	33764852	1758	chr2	33585473	33743466	Fam125b	-	157993	19628
chr2	34494336	34495336	1000	chr2	34505032	34505760	Gm13414	-	728	9696
chr2	34831414	34833650	2236	chr2	34838851	34916958	Hc	-	78107	5201
chr2	35063834	35065019	1185	chr2	35035725	35056640	Rab14	-	20915	7194
chr2	35087842	35089722	1880	chr2	35080055	35081774	Gm13605	+	1719	6068
chr2	37590682	37591898	1216	chr2	37338748	37559379	Strbp	-	220631	31303
chr2	37611851	37613467	1616	chr2	37631769	37654623	Crb2	+	22854	18302
chr2	37620105	37621682	1577	chr2	37631769	37654623	Crb2	+	22854	10087
chr2	37621763	37623866	2103	chr2	37631769	37654623	Crb2	+	22854	7903
chr2	38326474	38329265	2791	chr2	38335858	38335965	U6	+	107	6593
chr2	38842809	38844236	1427	chr2	38852233	38853778	Gm13496	-	1545	7997
chr2	39149789	39153031	3242	chr2	39129626	39130390	Vmn2r-ps2	+	764	19399
chr2	39180568	39181726	1158	chr2	39129626	39130390	Vmn2r-ps2	+	764	50178
chr2	43582421	43584002	1581	chr2	43604344	44251473	Arhgap15	+	647129	20342
chr2	43593588	43594939	1351	chr2	43604344	44251473	Arhgap15	+	647129	9405
chr2	44412162	44413255	1093	chr2	44419932	44783177	Gtdc1	-	363245	6677
chr2	44808290	44809290	1000	chr2	44419932	44783177	Gtdc1	-	363245	25113
chr2	45046980	45047980	1000	chr2	44839154	44972915	Zeb2	-	133761	74065
chr2	45049773	45053891	4118	chr2	44839154	44972915	Zeb2	-	133761	76858
chr2	45100237	45101237	1000	chr2	45184752	45184985	Gm13475	+	233	83515
chr2	45996608	45998495	1887	chr2	46161856	46161978	SNORA17	+	122	163361
chr2	46168842	46171773	2931	chr2	46161856	46161978	SNORA17	+	122	6864
chr2	46171777	46172862	1085	chr2	46161856	46161978	SNORA17	+	122	9799
chr2	46215307	46216439	1132	chr2	46261740	46262089	Gm13469	-	349	45301
chr2	46218525	46219525	1000	chr2	46261740	46262089	Gm13469	-	349	42215
chr2	46221195	46222195	1000	chr2	46261740	46262089	Gm13469	-	349	39545
chr2	46225750	46228314	2564	chr2	46261740	46262089	Gm13469	-	349	33426
chr2	46250977	46251977	1000	chr2	46261740	46262089	Gm13469	-	349	9763
chr2	49271882	49273870	1988	chr2	49253915	49254035	SNORA29	-	120	17847
chr2	49279821	49281475	1654	chr2	49307006	49407468	Epc2	+	100462	25531
chr2	50542447	50543588	1141	chr2	50513176	50513587	Gm13484	-	411	28860
chr2	51623413	51625575	2162	chr2	51512486	51587529	Gm13490	-	75043	35884
chr2	53526991	53527991	1000	chr2	53553406	53555881	Gm13502	-	2475	25415
chr2	61243450	61245393	1943	chr2	61330823	61330951	SNORA75	+	128	85430
chr2	61321342	61322961	1619	chr2	61330823	61330951	SNORA75	+	128	7862
chr2	61351558	61353572	2014	chr2	61330823	61330951	SNORA75	+	128	20607
chr2	61399868	61403254	3386	chr2	61416642	61492228	Tank	+	75586	13388
chr2	65655769	65657590	1821	chr2	65683824	65869603	Csrnp3	+	185779	26234
chr2	68620236	68621236	1000	chr2	68494543	68586522	4932414N04Rik	+	91979	33714
chr2	68966237	68968320	2083	chr2	68973857	69027387	Nostrin	+	53530	5537
chr2	69472901	69473948	1047	chr2	69485228	69505628	Bbs5	+	20400	11280
chr2	70673658	70675397	1739	chr2	70550464	70663785	Tlk1	-	113321	9873
chr2	70681102	70682610	1508	chr2	70694746	70695643	Gm13633	+	897	12136
chr2	70767325	70768325	1000	chr2	70802618	70893663	Mettl8	-	91045	34293
chr2	70768334	70769334	1000	chr2	70802618	70893663	Mettl8	-	91045	33284
chr2	70770310	70772386	2076	chr2	70802618	70893663	Mettl8	-	91045	30232
chr2	71215309	71216632	1323	chr2	71109120	71205806	Slc25a12	-	96686	9503
chr2	72107141	72108749	1608	chr2	71819272	72095531	Rapgef4	+	276259	11610
chr2	72675362	72677246	1884	chr2	72583903	72651774	6430710C18Rik	-	67871	23588
chr2	72705699	72707357	1658	chr2	72583903	72651774	6430710C18Rik	-	67871	53925
chr2	72832963	72835541	2578	chr2	72817481	72826734	1700011J10Rik	+	9253	6229
chr2	72840330	72843379	3049	chr2	72850911	72850984	Mir5115	-	73	7532
chr2	72861755	72862755	1000	chr2	72850911	72850984	Mir5115	-	73	10771
chr2	72870203	72871975	1772	chr2	72850911	72850984	Mir5115	-	73	19219
chr2	72877872	72879939	2067	chr2	72850911	72850984	Mir5115	-	73	26888
chr2	72891609	72892609	1000	chr2	72930858	73056981	Ola1	-	126123	38249
chr2	72893729	72894896	1167	chr2	72930858	73056981	Ola1	-	126123	35962
chr2	72897429	72899349	1920	chr2	72930858	73056981	Ola1	-	126123	31509
chr2	73378289	73379433	1144	chr2	73267667	73367791	Wipf1	-	100124	10498
chr2	75422502	75423998	1496	chr2	75470695	75471439	Gm13655	-	744	46697
chr2	75441055	75442055	1000	chr2	75470695	75471439	Gm13655	-	744	28640
chr2	75444499	75446435	1936	chr2	75470695	75471439	Gm13655	-	744	24260
chr2	75558050	75559458	1408	chr2	75567649	75568229	Gm13656	-	580	8191
chr2	75600725	75602717	1992	chr2	75615245	75620363	Gm13657	+	5118	12528
chr2	75605319	75607753	2434	chr2	75615245	75620363	Gm13657	+	5118	7492
chr2	75607893	75609643	1750	chr2	75615245	75620363	Gm13657	+	5118	5602
chr2	75625918	75627492	1574	chr2	75615245	75620363	Gm13657	+	5118	5555
chr2	75629683	75631584	1901	chr2	75615245	75620363	Gm13657	+	5118	9320
chr2	78799369	78800915	1546	chr2	78708281	78761450	Ube2e3	+	53169	37919
chr2	78801135	78802189	1054	chr2	78708281	78761450	Ube2e3	+	53169	39685
chr2	78815804	78822118	6314	chr2	78862978	78863428	Gm14466	-	450	40860
chr2	78870401	78871401	1000	chr2	78862978	78863428	Gm14466	-	450	6973
chr2	78890624	78891624	1000	chr2	78878690	78878891	Gm14469	-	201	11733
chr2	78896051	78897148	1097	chr2	78878690	78878891	Gm14469	-	201	17160
chr2	78899717	78903333	3616	chr2	78878690	78878891	Gm14469	-	201	20826
chr2	78926925	78928255	1330	chr2	78878690	78878891	Gm14469	-	201	48034
chr2	78960581	78961921	1340	chr2	79001186	79001752	Gm14465	-	566	39265
chr2	78963786	78965551	1765	chr2	79001186	79001752	Gm14465	-	566	35635
chr2	78970654	78972825	2171	chr2	79001186	79001752	Gm14465	-	566	28361
chr2	78974819	78979223	4404	chr2	79001186	79001752	Gm14465	-	566	21963
chr2	79020504	79021823	1319	chr2	79001186	79001752	Gm14465	-	566	18752
chr2	79534207	79537301	3094	chr2	79547937	79658653	Ppp1r1c	+	110716	10636
chr2	79538402	79539402	1000	chr2	79547937	79658653	Ppp1r1c	+	110716	8535
chr2	80143926	80145737	1811	chr2	80132629	80135513	Prdx6b	+	2884	8413
chr2	83898710	83900711	2001	chr2	83874400	83874770	Gm13692	-	370	23940
chr2	84062182	84063182	1000	chr2	83990212	83990312	AL772159.1	+	100	71870
chr2	84805536	84808528	2992	chr2	84776736	84798666	Slc43a3	+	21930	6870
chr2	90464190	90465190	1000	chr2	90269911	90420804	Ptprj	-	150893	43386
chr2	90471888	90472888	1000	chr2	90517372	90576485	Nup160	+	59113	44484
chr2	90489495	90491112	1617	chr2	90517372	90576485	Nup160	+	59113	26260
chr2	90492359	90493553	1194	chr2	90517372	90576485	Nup160	+	59113	23819
chr2	90507148	90509018	1870	chr2	90517372	90576485	Nup160	+	59113	8354
chr2	92677413	92679886	2473	chr2	92696324	92753820	Gm13791	-	57496	16438
chr2	92971223	92973699	2476	chr2	92926099	92938401	Gm13802	-	12302	32822
chr2	93002080	93003080	1000	chr2	93023045	93023131	AL683882.1	-	86	19965
chr2	93006511	93007660	1149	chr2	93023045	93023131	AL683882.1	-	86	15385
chr2	94113254	94114273	1019	chr2	94092036	94104915	E530001K10Rik	-	12879	8339
chr2	102751807	102756032	4225	chr2	102651298	102741822	Cd44	-	90524	9985
chr2	102784236	102785988	1752	chr2	102651298	102741822	Cd44	-	90524	42414
chr2	102787818	102790413	2595	chr2	102651298	102741822	Cd44	-	90524	45996
chr2	102796150	102800548	4398	chr2	102651298	102741822	Cd44	-	90524	54328
chr2	102807473	102809549	2076	chr2	102861232	102913670	Pdhx	-	52438	51683
chr2	102812357	102813577	1220	chr2	102861232	102913670	Pdhx	-	52438	47655
chr2	102820925	102822054	1129	chr2	102861232	102913670	Pdhx	-	52438	39178
chr2	102838370	102839503	1133	chr2	102861232	102913670	Pdhx	-	52438	21729
chr2	102844243	102845478	1235	chr2	102861232	102913670	Pdhx	-	52438	15754
chr2	103734482	103736231	1749	chr2	103728481	103728741	Gm13876	+	260	5741
chr2	103741354	103742354	1000	chr2	103752181	103759117	Gm13881	+	6936	9827
chr2	103774532	103776177	1645	chr2	103752181	103759117	Gm13881	+	6936	15415
chr2	103777854	103779730	1876	chr2	103798143	103822035	Lmo2	+	23892	18413
chr2	103780968	103781968	1000	chr2	103798143	103822035	Lmo2	+	23892	16175
chr2	103784519	103786386	1867	chr2	103798143	103822035	Lmo2	+	23892	11757
chr2	116768020	116769020	1000	chr2	116750174	116750283	snoU13	+	109	17737
chr2	116778598	116780450	1852	chr2	116788973	116789285	7SK	+	312	8523
chr2	116780507	116781507	1000	chr2	116788973	116789285	7SK	+	312	7466
chr2	116800150	116802254	2104	chr2	116793775	116793909	U1	-	134	6241
chr2	116814098	116816909	2811	chr2	116793775	116793909	U1	-	134	20189
chr2	116930625	116931726	1101	chr2	116947110	117008015	Spred1	+	60905	15384
chr2	117054733	117056942	2209	chr2	117066619	117067177	Rap1a-ps2	+	558	9677
chr2	117177286	117179086	1800	chr2	117105729	117168737	Rasgrp1	-	63008	8549
chr2	117215238	117216890	1652	chr2	117240128	117243433	Gm13982	-	3305	23238
chr2	117263747	117265113	1366	chr2	117240128	117243433	Gm13982	-	3305	20314
chr2	118315902	118317878	1976	chr2	118309049	118309913	Gm13983	-	864	5989
chr2	118324345	118325536	1191	chr2	118309049	118309913	Gm13983	-	864	14432
chr2	118344348	118346403	2055	chr2	118354493	118375423	Bmf	-	20930	8090
chr2	118387231	118388632	1401	chr2	118354493	118375423	Bmf	-	20930	11808
chr2	118481919	118482919	1000	chr2	118489039	118523756	Pak6	+	34717	6120
chr2	118766608	118767608	1000	chr2	118752233	118754321	Chst14	+	2088	12287
chr2	118797614	118799302	1688	chr2	118822804	118826420	Gm14089	+	3616	23502
chr2	118801262	118802950	1688	chr2	118822804	118826420	Gm14089	+	3616	19854
chr2	122200459	122202212	1753	chr2	122174628	122194898	Shf	-	20270	5561
chr2	122397459	122398513	1054	chr2	122420203	122437039	Gatm	-	16836	21690
chr2	122477267	122479139	1872	chr2	122462722	122466927	AA467197	+	4205	10340
chr2	124545250	124546321	1071	chr2	124534391	124536819	Gm13994	+	2428	8431
chr2	124557533	124559463	1930	chr2	124534391	124536819	Gm13994	+	2428	20714
chr2	124565867	124567656	1789	chr2	124534391	124536819	Gm13994	+	2428	29048
chr2	124576585	124579467	2882	chr2	124534391	124536819	Gm13994	+	2428	39766
chr2	124579492	124580970	1478	chr2	124534391	124536819	Gm13994	+	2428	42673
chr2	125616456	125617456	1000	chr2	125562722	125608606	Secisbp2l	-	45884	7850
chr2	126134927	126136070	1143	chr2	126146709	126326410	Atp8b4	-	179701	10639
chr2	126137085	126138682	1597	chr2	126146709	126326410	Atp8b4	-	179701	8027
chr2	126990877	126991877	1000	chr2	127012091	127034016	1810024B03Rik	-	21925	20214
chr2	127135768	127137348	1580	chr2	127095954	127124670	Stard7	+	28716	11098
chr2	127139512	127140594	1082	chr2	127095954	127124670	Stard7	+	28716	14842
chr2	127153534	127155949	2415	chr2	127161895	127164112	Dusp2	+	2217	5946
chr2	128005008	128006008	1000	chr2	128015723	128030370	Gm14009	+	14647	9715
chr2	128267695	128270012	2317	chr2	128021729	128255085	Gm14005	-	233356	12610
chr2	128274010	128278488	4478	chr2	128021729	128255085	Gm14005	-	233356	18925
chr2	128283116	128284697	1581	chr2	128021729	128255085	Gm14005	-	233356	28031
chr2	128285192	128286192	1000	chr2	128021729	128255085	Gm14005	-	233356	30107
chr2	128289825	128291811	1986	chr2	128021729	128255085	Gm14005	-	233356	34740
chr2	129155791	129157281	1490	chr2	129141065	129141215	U12	-	150	14576
chr2	129210256	129212124	1868	chr2	129204007	129205132	Gm14045	-	1125	5124
chr2	129411160	129412682	1522	chr2	129418571	129457964	Sirpa	+	39393	5889
chr2	129676351	129678451	2100	chr2	129626253	129658023	Stk35	+	31770	18328
chr2	131209478	131210478	1000	chr2	131239397	131239698	RNaseP_nuc	-	301	28919
chr2	131211487	131213586	2099	chr2	131239397	131239698	RNaseP_nuc	-	301	25811
chr2	131248362	131249441	1079	chr2	131240657	131240981	Gm14283	-	324	7381
chr2	131865003	131866665	1662	chr2	131815151	131855994	Rassf2	-	40843	9009
chr2	143917589	143920355	2766	chr2	143858795	143899715	Banf2	+	40920	17874
chr2	143921246	143923446	2200	chr2	143858795	143899715	Banf2	+	40920	21531
chr2	144038864	144040503	1639	chr2	143998886	144015026	Gm5535	-	16140	23838
chr2	144053478	144057163	3685	chr2	144068977	144070585	4930444E06Rik	+	1608	11814
chr2	148250685	148252638	1953	chr2	148244768	148245002	Gm14119	-	234	5683
chr2	148388527	148390118	1591	chr2	148450447	148450558	SNORA17	+	111	60329
chr2	148718019	148719948	1929	chr2	148697458	148701428	Cst3	-	3970	16591
chr2	152486817	152487817	1000	chr2	152478619	152480066	1700030C14Rik	-	1447	6751
chr2	152916136	152917301	1165	chr2	152891691	152907471	BC020535	+	15780	8665
chr2	153103503	153105082	1579	chr2	153067269	153095983	Pofut1	+	28714	7520
chr2	153367639	153371590	3951	chr2	153233198	153355707	8430427H17Rik	-	122509	11932
chr2	153386227	153387806	1579	chr2	153233198	153355707	8430427H17Rik	-	122509	30520
chr2	154251963	154252968	1005	chr2	154262217	154365092	Cbfa2t2	+	102875	9249
chr2	154582682	154583760	1078	chr2	154594991	154595766	Gm14214	-	775	11231
chr2	157979271	157980271	1000	chr2	157942138	157972172	Tgm2	-	30034	7099
chr2	157985070	157986717	1647	chr2	157942138	157972172	Tgm2	-	30034	12898
chr2	157991745	157993576	1831	chr2	158008269	158054958	D630003M21Rik	-	46689	14693
chr2	161336700	161338793	2093	chr2	161347726	162486883	Ptprt	-	1139157	8933
chr2	162927643	162930198	2555	chr2	162918635	162918759	AL591584.1	+	124	8884
chr2	164345952	164349257	3305	chr2	164323020	164333801	Pigt	+	10781	12151
chr2	164692344	164694936	2592	chr2	164665018	164683211	Pltp	-	18193	9133
chr2	165739752	165740977	1225	chr2	165733551	165733675	AL589902.1	-	124	6077
chr2	165742461	165743631	1170	chr2	165750766	165751341	Gm11461	-	575	7135
chr2	165772928	165774341	1413	chr2	165785289	165785850	Gm11462	+	561	10948
chr2	165774904	165775904	1000	chr2	165785289	165785850	Gm11462	+	561	9385
chr2	166154432	166155480	1048	chr2	166099408	166120331	Gm11468	+	20923	34101
chr2	166155954	166157729	1775	chr2	166099408	166120331	Gm11468	+	20923	35623
chr2	166296566	166297566	1000	chr2	166272951	166284732	5031425F14Rik	+	11781	11834
chr2	166556862	166558698	1836	chr2	166391842	166539332	Prex1	-	147490	17530
chr2	166570455	166572957	2502	chr2	166594245	166594347	U6	+	102	21288
chr2	166897020	166898038	1018	chr2	166888434	166891362	1500012F01Rik	+	2928	5658
chr2	166906644	166907644	1000	chr2	166912684	166913239	Gm11472	-	555	5040
chr2	167095272	167096534	1262	chr2	167106919	167107277	Gm11473	-	358	10385
chr2	167182091	167183232	1141	chr2	167123944	167174683	B4galt5	-	50739	7408
chr2	167183283	167184283	1000	chr2	167123944	167174683	B4galt5	-	50739	8600
chr2	167184429	167187637	3208	chr2	167123944	167174683	B4galt5	-	50739	9746
chr2	167187917	167188951	1034	chr2	167123944	167174683	B4galt5	-	50739	13234
chr2	167199961	167201566	1605	chr2	167123944	167174683	B4galt5	-	50739	25278
chr2	167207024	167208024	1000	chr2	167123944	167174683	B4galt5	-	50739	32341
chr2	167208125	167209221	1096	chr2	167123944	167174683	B4galt5	-	50739	33442
chr2	167629772	167632326	2554	chr2	167607553	167608986	9230111E07Rik	+	1433	20786
chr2	167735202	167736310	1108	chr2	167757557	167804885	Ptpn1	+	47328	21247
chr2	167942442	167943579	1137	chr2	167906504	167926703	Pard6b	+	20199	15739
chr2	167995115	167996115	1000	chr2	168003658	168003752	BX005039.1	-	94	7543
chr2	168263243	168264243	1000	chr2	168243230	168244074	Gm14234	-	844	19169
chr2	169979620	169981312	1692	chr2	169934143	169973603	Zfp217	-	39460	6017
chr2	169982563	169984304	1741	chr2	169934143	169973603	Zfp217	-	39460	8960
chr2	169984827	169986423	1596	chr2	169934143	169973603	Zfp217	-	39460	11224
chr2	169994434	169995729	1295	chr2	169934143	169973603	Zfp217	-	39460	20831
chr2	170027290	170028347	1057	chr2	170017949	170019553	Gm17619	-	1604	7737
chr2	170030376	170031431	1055	chr2	170017949	170019553	Gm17619	-	1604	10823
chr2	170069292	170070483	1191	chr2	170110535	170111380	Gm14270	+	845	40052
chr2	170070797	170072539	1742	chr2	170110535	170111380	Gm14270	+	845	37996
chr2	170077406	170079406	2000	chr2	170110535	170111380	Gm14270	+	845	31129
chr2	170084424	170086389	1965	chr2	170110535	170111380	Gm14270	+	845	24146
chr2	170092199	170093199	1000	chr2	170110535	170111380	Gm14270	+	845	17336
chr2	170098457	170100423	1966	chr2	170110535	170111380	Gm14270	+	845	10112
chr2	170100514	170102221	1707	chr2	170110535	170111380	Gm14270	+	845	8314
chr2	170117165	170118165	1000	chr2	170110535	170111380	Gm14270	+	845	5785
chr2	170143908	170146258	2350	chr2	170172491	170253345	Bcas1	-	80854	26233
chr2	170146748	170148705	1957	chr2	170172491	170253345	Bcas1	-	80854	23786
chr2	172791581	172792581	1000	chr2	172803201	172819077	Spo11	+	15876	10620
chr2	172871559	172873001	1442	chr2	172845999	172860235	Rbm38	+	14236	11324
chr2	172885410	172888639	3229	chr2	172845999	172860235	Rbm38	+	14236	25175
chr2	172908552	172912227	3675	chr2	172919110	172945026	Ctcfl	-	25916	6883
chr2	173141465	173142705	1240	chr2	173102199	173103929	Gm14454	+	1730	37536
chr2	173174473	173175473	1000	chr2	173220067	173221221	Gm14642	+	1154	44594
chr2	173203089	173204089	1000	chr2	173220067	173221221	Gm14642	+	1154	15978
chr2	173210561	173212275	1714	chr2	173220067	173221221	Gm14642	+	1154	7792
chr2	173212557	173214544	1987	chr2	173220067	173221221	Gm14642	+	1154	5523
chr2	173226991	173227991	1000	chr2	173220067	173221221	Gm14642	+	1154	5770
chr2	173244129	173245129	1000	chr2	173220067	173221221	Gm14642	+	1154	22908
chr2	173261532	173262717	1185	chr2	173220067	173221221	Gm14642	+	1154	40311
chr2	173269793	173271472	1679	chr2	173220067	173221221	Gm14642	+	1154	48572
chr2	173272958	173275415	2457	chr2	173220067	173221221	Gm14642	+	1154	51737
chr2	173290413	173291413	1000	chr2	173348087	173354002	1700021F07Rik	+	5915	56674
chr2	173293749	173295794	2045	chr2	173348087	173354002	1700021F07Rik	+	5915	52293
chr2	173324392	173326372	1980	chr2	173348087	173354002	1700021F07Rik	+	5915	21715
chr2	173359489	173360489	1000	chr2	173348087	173354002	1700021F07Rik	+	5915	5487
chr2	174341621	174343601	1980	chr2	174310202	174311077	Gm14385	-	875	30544
chr2	174389256	174390256	1000	chr2	174416731	174417303	Vmn1r-ps1	+	572	26475
chr2	174390678	174392439	1761	chr2	174416731	174417303	Vmn1r-ps1	+	572	24292
chr2	174394422	174396561	2139	chr2	174416731	174417303	Vmn1r-ps1	+	572	20170
chr2	174427179	174428770	1591	chr2	174416731	174417303	Vmn1r-ps1	+	572	9876
chr2	174437611	174439841	2230	chr2	174416731	174417303	Vmn1r-ps1	+	572	20308
chr2	174705471	174707234	1763	chr2	174681790	174692032	Gm14616	+	10242	13439
chr2	178240148	178241592	1444	chr2	178165236	178222071	Cdh26	+	56835	18077
chr2	178279441	178283121	3680	chr2	178165236	178222071	Cdh26	+	56835	57370
chr2	178290361	178293971	3610	chr2	178165236	178222071	Cdh26	+	56835	68290
chr2	178299536	178302372	2836	chr2	178165236	178222071	Cdh26	+	56835	77465
chr2	178308867	178309879	1012	chr2	178165236	178222071	Cdh26	+	56835	86796
chr2	180034990	180036361	1371	chr2	180012351	180024584	BC066135	-	12233	10406
chr2	180041611	180042730	1119	chr2	180012351	180024584	BC066135	-	12233	17027
chr2	180177952	180179613	1661	chr2	180190950	180209572	Slco4a1	+	18622	11337
chr2	180183100	180184180	1080	chr2	180190950	180209572	Slco4a1	+	18622	6770
chr2	181216894	181219474	2580	chr2	181227911	181229685	Abhd16b	+	1774	8437
chr2	6380548	6382038	1490	chr2	6393046	6399665	Gm13391	+	6619	11008
chr2	11253473	11255282	1809	chr2	11261116	11264239	Gm13293	+	3123	5834
chr2	11557946	11559046	1100	chr2	11564419	11614818	Il2ra	+	50399	5373
chr2	17663047	17664421	1374	chr2	17265536	17653091	Nebl	-	387555	9956
chr2	17775509	17776580	1071	chr2	17718461	17719611	Gm13323	-	1150	55898
chr2	17841100	17842100	1000	chr2	17918049	17918573	H2afb1	-	524	75949
chr2	18508546	18509546	1000	chr2	18489753	18489825	Gm13353	+	72	18721
chr2	18688395	18689568	1173	chr2	18664342	18682489	Gm20539	-	18147	5906
chr2	22599345	22600495	1150	chr2	22611504	22617793	1700092C17Rik	+	6289	11009
chr2	24167629	24168629	1000	chr2	24177944	24178476	Gm13411	+	532	9315
chr2	30797714	30798751	1037	chr2	30808479	30814535	Tor1b	+	6056	9728
chr2	31736306	31737306	1000	chr2	31742454	31747937	Gm13441	-	5483	5148
chr2	34825985	34827119	1134	chr2	34820397	34820424	Gm13450	-	27	5561
chr2	44811959	44813554	1595	chr2	44839154	44972915	Zeb2	-	133761	25600
chr2	52621750	52622857	1107	chr2	52547183	52601315	Stam2	-	54132	20435
chr2	70682653	70683928	1275	chr2	70694746	70695643	Gm13633	+	897	10818
chr2	71704096	71705223	1127	chr2	71711281	71741915	Pdk1	+	30634	6058
chr2	73392414	73393414	1000	chr2	73401272	73418395	Chrna1	-	17123	7858
chr2	75083830	75084830	1000	chr2	75030334	75030849	Gm13653	+	515	52981
chr2	79068035	79069140	1105	chr2	79095583	79173280	Itga4	+	77697	26443
chr2	84804257	84805358	1101	chr2	84776736	84798666	Slc43a3	+	21930	5591
chr2	103336022	103337219	1197	chr2	103294006	103325317	Cat	-	31311	10705
chr2	121846600	121847600	1000	chr2	121854282	121882334	Eif3j	+	28052	6682
chr2	122202950	122204754	1804	chr2	122211225	122211376	U1	-	151	6471
chr2	122234593	122235716	1123	chr2	122251126	122286873	Slc28a2	+	35747	15410
chr2	122491910	122492910	1000	chr2	122506969	122528399	Slc30a4	-	21430	14059
chr2	125617744	125618786	1042	chr2	125562722	125608606	Secisbp2l	-	45884	9138
chr2	127148567	127150587	2020	chr2	127161895	127164112	Dusp2	+	2217	11308
chr2	128370780	128371780	1000	chr2	128382990	128383942	Gm14006	-	952	11210
chr2	131218381	131219704	1323	chr2	131239397	131239698	RNaseP_nuc	-	301	19693
chr2	143937654	143939464	1810	chr2	143968224	143969109	Gm11687	-	885	28760
chr2	144113040	144114040	1000	chr2	144096399	144106963	8430406I07Rik	+	10564	6077
chr2	148201217	148202217	1000	chr2	148221113	148226239	Sstr4	+	5126	18896
chr2	156015624	156017133	1509	chr2	156022202	156135688	Phf20	+	113486	5069
chr2	158000965	158002145	1180	chr2	158008269	158054958	D630003M21Rik	-	46689	6124
chr2	167096571	167097779	1208	chr2	167106919	167107277	Gm11473	-	358	9140
chr2	167193268	167194295	1027	chr2	167123944	167174683	B4galt5	-	50739	18585
chr2	167750427	167751952	1525	chr2	167757557	167804885	Ptpn1	+	47328	5605
chr2	168255088	168256088	1000	chr2	168243230	168244074	Gm14234	-	844	11014
chr2	169999517	170001402	1885	chr2	170017949	170019553	Gm17619	-	1604	16547
chr2	170009970	170011056	1086	chr2	170017949	170019553	Gm17619	-	1604	6893
chr2	170043084	170044224	1140	chr2	170017949	170019553	Gm17619	-	1604	23531
chr2	170044344	170045374	1030	chr2	170017949	170019553	Gm17619	-	1604	24791
chr2	170073256	170074256	1000	chr2	170110535	170111380	Gm14270	+	845	36279
chr2	172873027	172877011	3984	chr2	172845999	172860235	Rbm38	+	14236	12792
chr2	173234300	173235396	1096	chr2	173220067	173221221	Gm14642	+	1154	13079
chr2	173277698	173278884	1186	chr2	173220067	173221221	Gm14642	+	1154	56477
chr2	180168089	180169169	1080	chr2	180190950	180209572	Slco4a1	+	18622	21781
chr2	180171968	180173143	1175	chr2	180190950	180209572	Slco4a1	+	18622	17807
chr3	5819437	5820437	1000	chr3	5560188	5576239	Pxmp3	-	16051	243198
chr3	8634888	8635888	1000	chr3	8663362	8667039	Hey1	-	3677	27474
chr3	9033602	9034997	1395	chr3	8928626	9004723	Tpd52	-	76097	28879
chr3	9109514	9110514	1000	chr3	8928626	9004723	Tpd52	-	76097	104791
chr3	9150571	9152775	2204	chr3	9250602	9285333	Zbtb10	+	34731	97827
chr3	9152833	9154756	1923	chr3	9250602	9285333	Zbtb10	+	34731	95846
chr3	9843942	9845099	1157	chr3	9687479	9833679	Pag1	-	146200	10263
chr3	9861945	9864361	2416	chr3	9687479	9833679	Pag1	-	146200	28266
chr3	9884278	9886100	1822	chr3	9687479	9833679	Pag1	-	146200	50599
chr3	9892260	9895092	2832	chr3	9687479	9833679	Pag1	-	146200	58581
chr3	9895315	9896315	1000	chr3	9687479	9833679	Pag1	-	146200	61636
chr3	10076954	10078015	1061	chr3	10088173	10092564	Gm9833	+	4391	10158
chr3	14750146	14752873	2727	chr3	14766217	14778459	Car1	-	12242	13344
chr3	14911717	14912956	1239	chr3	14886426	14900769	Car2	+	14343	10948
chr3	15178678	15179905	1227	chr3	15296551	15332302	Gm9733	-	35751	116646
chr3	15196013	15197013	1000	chr3	15296551	15332302	Gm9733	-	35751	99538
chr3	15227192	15229092	1900	chr3	15296551	15332302	Gm9733	-	35751	67459
chr3	19218511	19220873	2362	chr3	19123108	19211322	Pde7a	-	88214	7189
chr3	19247308	19251210	3902	chr3	19230773	19231084	7SK	+	311	16224
chr3	19319172	19322485	3313	chr3	19408595	19510862	Dnajc5b	+	102267	86110
chr3	19328628	19331327	2699	chr3	19408595	19510862	Dnajc5b	+	102267	77268
chr3	21461645	21462645	1000	chr3	20948487	20949170	Gm7488	+	683	512475
chr3	21815669	21817597	1928	chr3	21975574	22115516	Tbl1xr1	+	139942	157977
chr3	21833877	21836214	2337	chr3	21975574	22115516	Tbl1xr1	+	139942	139360
chr3	21839616	21842881	3265	chr3	21975574	22115516	Tbl1xr1	+	139942	132693
chr3	21863232	21864890	1658	chr3	21975574	22115516	Tbl1xr1	+	139942	110684
chr3	21867722	21869089	1367	chr3	21975574	22115516	Tbl1xr1	+	139942	106485
chr3	21870055	21873881	3826	chr3	21975574	22115516	Tbl1xr1	+	139942	101693
chr3	21881694	21882748	1054	chr3	21975574	22115516	Tbl1xr1	+	139942	92826
chr3	21882788	21884839	2051	chr3	21975574	22115516	Tbl1xr1	+	139942	90735
chr3	21886475	21889615	3140	chr3	21975574	22115516	Tbl1xr1	+	139942	85959
chr3	21889997	21891616	1619	chr3	21975574	22115516	Tbl1xr1	+	139942	83958
chr3	21920015	21921015	1000	chr3	21975574	22115516	Tbl1xr1	+	139942	54559
chr3	30959569	30961358	1789	chr3	30894669	30951663	Prkci	+	56994	7906
chr3	30981081	30982081	1000	chr3	30993980	31021499	Skil	+	27519	11899
chr3	30982295	30983846	1551	chr3	30993980	31021499	Skil	+	27519	10134
chr3	31037403	31038403	1000	chr3	31048868	31063246	Cldn11	+	14378	10465
chr3	32407360	32408886	1526	chr3	32414217	32419607	Zfp639	+	5390	5331
chr3	35591879	35593003	1124	chr3	35634295	35634399	U6	+	104	41292
chr3	36049570	36050688	1118	chr3	36058444	36065142	D3Ertd254e	+	6698	7756
chr3	36387339	36388339	1000	chr3	36375057	36380898	1810062G17Rik	+	5841	6441
chr3	36752318	36753833	1515	chr3	36762028	36951955	4932438A13Rik	+	189927	8195
chr3	37178185	37180142	1957	chr3	37155706	37155815	AL691478.1	-	109	22370
chr3	37190565	37191565	1000	chr3	37206671	37211630	Cetn4	-	4959	15106
chr3	37197663	37199516	1853	chr3	37206671	37211630	Cetn4	-	4959	7155
chr3	38099673	38101731	2058	chr3	38166760	38167006	AC162799.1	-	246	65029
chr3	41211843	41213466	1623	chr3	41245265	41245389	SNORD22	-	124	31799
chr3	50419238	50420613	1375	chr3	50356865	50356959	U6atac	+	94	62279
chr3	51000437	51001437	1000	chr3	51028369	51055566	Ccrn4l	+	27197	26932
chr3	51176317	51177840	1523	chr3	51192337	51200660	4930583H14Rik	-	8323	14497
chr3	51181639	51183157	1518	chr3	51192337	51200660	4930583H14Rik	-	8323	9180
chr3	51456007	51458214	2207	chr3	51464282	51486597	Mgst2	+	22315	6068
chr3	51974392	51975392	1000	chr3	51491533	51908813	Maml3	-	417280	65579
chr3	51999594	52000779	1185	chr3	52072259	52154031	Foxo1	+	81772	71480
chr3	52001771	52004341	2570	chr3	52072259	52154031	Foxo1	+	81772	67918
chr3	52061260	52062419	1159	chr3	52072259	52154031	Foxo1	+	81772	9840
chr3	52199426	52206018	6592	chr3	52072259	52154031	Foxo1	+	81772	45395
chr3	52261947	52263106	1159	chr3	52072259	52154031	Foxo1	+	81772	107916
chr3	52271535	52275277	3742	chr3	52072259	52154031	Foxo1	+	81772	117504
chr3	52358203	52359936	1733	chr3	52416707	52417938	Gm10293	+	1231	56771
chr3	52371234	52373484	2250	chr3	52416707	52417938	Gm10293	+	1231	43223
chr3	52375646	52377147	1501	chr3	52416707	52417938	Gm10293	+	1231	39560
chr3	52436871	52439396	2525	chr3	52416707	52417938	Gm10293	+	1231	18933
chr3	52442028	52443028	1000	chr3	52416707	52417938	Gm10293	+	1231	24090
chr3	52558340	52559711	1371	chr3	52526571	52526677	U6	-	106	31663
chr3	52561376	52562940	1564	chr3	52526571	52526677	U6	-	106	34699
chr3	52594309	52596600	2291	chr3	52526571	52526677	U6	-	106	67632
chr3	52643755	52645418	1663	chr3	52526571	52526677	U6	-	106	117078
chr3	52646369	52648514	2145	chr3	52526571	52526677	U6	-	106	119692
chr3	52727366	52728624	1258	chr3	52786045	52821145	Cog6	-	35100	57421
chr3	52733624	52734774	1150	chr3	52786045	52821145	Cog6	-	35100	51271
chr3	52757498	52758498	1000	chr3	52786045	52821145	Cog6	-	35100	27547
chr3	53088044	53089044	1000	chr3	52845450	53065601	Lhfp	+	220151	22443
chr3	53778445	53780241	1796	chr3	53659134	53667752	Ufm1	-	8618	110693
chr3	53780662	53782189	1527	chr3	53659134	53667752	Ufm1	-	8618	112910
chr3	54393344	54394741	1397	chr3	54435361	54438549	Gm17556	+	3188	40620
chr3	54396253	54397253	1000	chr3	54435361	54438549	Gm17556	+	3188	38108
chr3	57717807	57720305	2498	chr3	57726010	57726109	U6	-	99	5705
chr3	57926061	57927061	1000	chr3	57906916	57908169	Gm5537	-	1253	17892
chr3	58305371	58306822	1451	chr3	58325891	58329795	Serp1	-	3904	19069
chr3	58311818	58313234	1416	chr3	58325891	58329795	Serp1	-	3904	12657
chr3	60210543	60213377	2834	chr3	60277032	60433670	Mbnl1	+	156638	63655
chr3	60241396	60246955	5559	chr3	60277032	60433670	Mbnl1	+	156638	30077
chr3	65238061	65241408	3347	chr3	65197259	65199106	Gm5540	+	1847	38955
chr3	65245523	65246550	1027	chr3	65197259	65199106	Gm5540	+	1847	46417
chr3	65396718	65397718	1000	chr3	65332332	65359067	Tiparp	+	26735	37651
chr3	65406412	65409168	2756	chr3	65332332	65359067	Tiparp	+	26735	47345
chr3	65422565	65424276	1711	chr3	65470150	65635084	Lekr1	+	164934	45874
chr3	65428789	65432063	3274	chr3	65470150	65635084	Lekr1	+	164934	38087
chr3	65432690	65434047	1357	chr3	65470150	65635084	Lekr1	+	164934	36103
chr3	65725226	65727492	2266	chr3	65750073	65762171	Ccnl1	-	12098	22581
chr3	65728503	65729503	1000	chr3	65750073	65762171	Ccnl1	-	12098	20570
chr3	65732866	65734544	1678	chr3	65750073	65762171	Ccnl1	-	12098	15529
chr3	65778052	65779096	1044	chr3	65750073	65762171	Ccnl1	-	12098	15881
chr3	67360536	67362138	1602	chr3	67377082	67377213	SNORA17	-	131	14944
chr3	68441368	68442665	1297	chr3	67868864	68430404	Schip1	+	561540	10964
chr3	68480049	68481589	1540	chr3	68494566	68502469	Il12a	+	7903	12977
chr3	68508749	68510960	2211	chr3	68494566	68502469	Il12a	+	7903	6280
chr3	68959769	68961500	1731	chr3	68871071	68931035	Kpna4	-	59964	28734
chr3	69008992	69010191	1199	chr3	69026341	69027538	Arl14	+	1197	16150
chr3	69015220	69018081	2861	chr3	69026341	69027538	Arl14	+	1197	8260
chr3	69559665	69561645	1980	chr3	69525907	69552964	Nmd3	+	27057	6701
chr3	69907847	69908847	1000	chr3	69811535	69832630	Otol1	+	21095	75217
chr3	71367632	71368632	1000	chr3	70576301	70611213	Gm6634	-	34912	756419
chr3	75100343	75101900	1557	chr3	75046292	75074000	Serpini2	-	27708	26343
chr3	75470876	75471876	1000	chr3	75361469	75447417	Serpini1	+	85948	23459
chr3	75547364	75548980	1616	chr3	75518712	75518846	SNORA17	+	134	28518
chr3	75638218	75639908	1690	chr3	75680105	75760871	Golim4	-	80766	40197
chr3	78702735	78704726	1991	chr3	78695786	78696373	Gm5277	-	587	6362
chr3	79040966	79043650	2684	chr3	79000296	79000399	U6	+	103	40567
chr3	79056177	79057682	1505	chr3	79000296	79000399	U6	+	103	55778
chr3	79089623	79091989	2366	chr3	79149298	79268051	Gm17359	+	118753	57309
chr3	79550359	79551359	1000	chr3	79448638	79541716	Rxfp1	-	93078	8643
chr3	80624390	80626180	1790	chr3	80488858	80606713	Gria2	-	117855	17677
chr3	81564120	81565120	1000	chr3	81684649	81684788	SNORA17	+	139	119529
chr3	81586653	81587653	1000	chr3	81684649	81684788	SNORA17	+	139	96996
chr3	83666351	83667382	1031	chr3	83640195	83645689	Tlr2	-	5494	20662
chr3	83865135	83866260	1125	chr3	83702131	83844083	D930015E06Rik	-	141952	21052
chr3	83866673	83870390	3717	chr3	83891856	83959708	Mnd1	-	67852	21466
chr3	83872753	83876102	3349	chr3	83891856	83959708	Mnd1	-	67852	15754
chr3	84116375	84117984	1609	chr3	83964361	84109368	Trim2	-	145007	7007
chr3	84140938	84141998	1060	chr3	83964361	84109368	Trim2	-	145007	31570
chr3	85698017	85699986	1969	chr3	85604969	85691440	Glt28d2	-	86471	6577
chr3	86014126	86015221	1095	chr3	86028602	86586615	Lrba	+	558013	13381
chr3	86017386	86020363	2977	chr3	86028602	86586615	Lrba	+	558013	8239
chr3	86764196	86765196	1000	chr3	86790508	86793455	Cd1d2	+	2947	25312
chr3	86820865	86822063	1198	chr3	86799756	86803363	Cd1d1	-	3607	17502
chr3	86832675	86833675	1000	chr3	86799756	86803363	Cd1d1	-	3607	29312
chr3	87018380	87019713	1333	chr3	87011463	87011927	Gm10705	-	464	6453
chr3	87023523	87025777	2254	chr3	87011463	87011927	Gm10705	-	464	11596
chr3	87204615	87206560	1945	chr3	87180309	87196055	Fcrl1	+	15746	8560
chr3	87225679	87229051	3372	chr3	87239807	87261758	Fcrl5	+	21951	10756
chr3	87291238	87292289	1051	chr3	87239807	87261758	Fcrl5	+	21951	29480
chr3	87302397	87303479	1082	chr3	87329329	87344078	Etv3	+	14749	25850
chr3	87303497	87304608	1111	chr3	87329329	87344078	Etv3	+	14749	24721
chr3	87305241	87309388	4147	chr3	87329329	87344078	Etv3	+	14749	19941
chr3	87309732	87311925	2193	chr3	87329329	87344078	Etv3	+	14749	17404
chr3	87314042	87318131	4089	chr3	87329329	87344078	Etv3	+	14749	11198
chr3	87318673	87319692	1019	chr3	87329329	87344078	Etv3	+	14749	9637
chr3	87321627	87323285	1658	chr3	87329329	87344078	Etv3	+	14749	6044
chr3	87359751	87361636	1885	chr3	87329329	87344078	Etv3	+	14749	15673
chr3	87635513	87637336	1823	chr3	87551812	87628181	Pear1	-	76369	7332
chr3	87936572	87938288	1716	chr3	87946294	87976008	Mef2d	+	29714	8006
chr3	88036520	88039032	2512	chr3	88046796	88091132	Rhbg	-	44336	7764
chr3	88323985	88326768	2783	chr3	88336317	88345318	Mex3a	+	9001	9549
chr3	89294904	89296900	1996	chr3	89263040	89272935	Pmvk	+	9895	21969
chr3	89604891	89607361	2470	chr3	89577531	89587919	Ube2q1	+	10388	16972
chr3	90096029	90098611	2582	chr3	90069107	90084591	Dennd4b	+	15484	11438
chr3	90389900	90393852	3952	chr3	90404137	90406624	S100a3	+	2487	10285
chr3	91957771	91958771	1000	chr3	91938916	91946676	Lelp1	-	7760	11095
chr3	93308714	93310832	2118	chr3	93324410	93330209	S100a11	+	5799	13578
chr3	93346558	93350054	3496	chr3	93359002	93368565	S100a10	+	9563	8948
chr3	93395032	93397834	2802	chr3	93359002	93368565	S100a10	+	9563	26467
chr3	93400324	93403096	2772	chr3	93359002	93368565	S100a10	+	9563	31759
chr3	95324054	95325673	1619	chr3	95330708	95360325	Ctss	+	29617	5035
chr3	95472198	95473412	1214	chr3	95462643	95467099	Mcl1	+	4456	5099
chr3	95757636	95762381	4745	chr3	95733169	95751313	Anp32e	+	18144	6323
chr3	95772571	95773571	1000	chr3	95792352	95799924	Plekho1	-	7572	18781
chr3	95782328	95784657	2329	chr3	95792352	95799924	Plekho1	-	7572	7695
chr3	95872891	95875126	2235	chr3	95803755	95862389	Vps45	-	58634	10502
chr3	95876612	95877739	1127	chr3	95803755	95862389	Vps45	-	58634	14223
chr3	96104167	96105638	1471	chr3	96086832	96098179	Fcgr1	-	11347	5988
chr3	96303306	96307367	4061	chr3	96292652	96292816	U1	+	164	10490
chr3	97782530	97783530	1000	chr3	97734096	97770941	Gm5544	+	36845	11589
chr3	98151346	98153012	1666	chr3	98117093	98143913	Phgdh	-	26820	7433
chr3	100162323	100165324	3001	chr3	100217483	100218483	Gm12464	+	1000	52159
chr3	100167882	100169156	1274	chr3	100217483	100218483	Gm12464	+	1000	48327
chr3	100246974	100248029	1055	chr3	100230328	100241677	4930406D18Rik	+	11349	5297
chr3	100505824	100507519	1695	chr3	100366130	100489426	Man1a2	-	123296	16398
chr3	100508964	100509998	1034	chr3	100366130	100489426	Man1a2	-	123296	19538
chr3	101464921	101465921	1000	chr3	101380142	101408586	Atp1a1	-	28444	56335
chr3	104245328	104246328	1000	chr3	104257907	104315840	Lrig2	-	57933	11579
chr3	104740298	104741724	1426	chr3	104747723	104764627	Wnt2b	-	16904	5999
chr3	105091556	105092556	1000	chr3	105244513	105255873	1700095B22Rik	-	11360	151957
chr3	105609713	105612157	2444	chr3	105530185	105604248	Rap1a	-	74063	5465
chr3	105617533	105619626	2093	chr3	105530185	105604248	Rap1a	-	74063	13285
chr3	105620487	105622654	2167	chr3	105530185	105604248	Rap1a	-	74063	16239
chr3	105627089	105631567	4478	chr3	105530185	105604248	Rap1a	-	74063	22841
chr3	105659820	105660820	1000	chr3	105673776	105711846	Adora3	+	38070	12956
chr3	106264353	106266009	1656	chr3	106284931	106286355	2010016I18Rik	-	1424	18922
chr3	106611331	106613140	1809	chr3	106624474	106625500	Olfr266	-	1026	11334
chr3	106633412	106636450	3038	chr3	106624474	106625500	Olfr266	-	1026	7912
chr3	106674178	106676264	2086	chr3	106624474	106625500	Olfr266	-	1026	48678
chr3	106798159	106799196	1037	chr3	106839080	106841047	Kcna3	+	1967	39884
chr3	106865230	106867009	1779	chr3	106842422	106854070	AI504432	+	11648	11160
chr3	106877233	106879913	2680	chr3	106893880	106901319	A930002I21Rik	+	7439	13967
chr3	106886670	106888499	1829	chr3	106893880	106901319	A930002I21Rik	+	7439	5381
chr3	107578209	107579868	1659	chr3	107543966	107563387	Csf1	-	19421	14822
chr3	107599533	107601009	1476	chr3	107543966	107563387	Csf1	-	19421	36146
chr3	107617229	107618966	1737	chr3	107543966	107563387	Csf1	-	19421	53842
chr3	107620328	107624076	3748	chr3	107680148	107695817	Eps8l3	+	15669	56072
chr3	107624657	107627451	2794	chr3	107680148	107695817	Eps8l3	+	15669	52697
chr3	107634905	107637864	2959	chr3	107680148	107695817	Eps8l3	+	15669	42284
chr3	107648396	107650742	2346	chr3	107680148	107695817	Eps8l3	+	15669	29406
chr3	107651188	107654186	2998	chr3	107680148	107695817	Eps8l3	+	15669	25962
chr3	107655100	107657964	2864	chr3	107680148	107695817	Eps8l3	+	15669	22184
chr3	109057115	109059131	2016	chr3	108994921	108995785	Gm13865	-	864	61330
chr3	109549614	109551772	2158	chr3	109582958	109938426	Ntng1	-	355468	31186
chr3	115240752	115242359	1607	chr3	115186934	115187054	AC161513.1	-	120	53698
chr3	115344466	115346589	2123	chr3	115413351	115417973	S1pr1	-	4622	66762
chr3	115346607	115348645	2038	chr3	115413351	115417973	S1pr1	-	4622	64706
chr3	115383958	115384958	1000	chr3	115413351	115417973	S1pr1	-	4622	28393
chr3	115385137	115386715	1578	chr3	115413351	115417973	S1pr1	-	4622	26636
chr3	115391820	115393272	1452	chr3	115413351	115417973	S1pr1	-	4622	20079
chr3	115395733	115396983	1250	chr3	115413351	115417973	S1pr1	-	4622	16368
chr3	115404418	115406253	1835	chr3	115413351	115417973	S1pr1	-	4622	7098
chr3	115406892	115407892	1000	chr3	115413351	115417973	S1pr1	-	4622	5459
chr3	115431313	115432519	1206	chr3	115418068	115419645	Gm9889	+	1577	11668
chr3	115461103	115462218	1115	chr3	115418068	115419645	Gm9889	+	1577	41458
chr3	115518224	115519404	1180	chr3	115590740	115591048	A930005H10Rik	-	308	71336
chr3	115520972	115522759	1787	chr3	115590740	115591048	A930005H10Rik	-	308	67981
chr3	115557629	115558629	1000	chr3	115590740	115591048	A930005H10Rik	-	308	32111
chr3	115560751	115562314	1563	chr3	115590740	115591048	A930005H10Rik	-	308	28426
chr3	116136735	116138835	2100	chr3	115975471	116126950	Cdc14a	-	151479	9785
chr3	118210273	118211289	1016	chr3	118265047	119135836	Dpyd	+	870789	53758
chr3	119510089	119511089	1000	chr3	119534855	119534975	AC111029.1	+	120	23766
chr3	121071828	121075163	3335	chr3	120994735	121064929	Alg14	+	70194	6899
chr3	121250071	121252008	1937	chr3	121234529	121238356	A530020G20Rik	+	3827	11715
chr3	121272350	121273350	1000	chr3	121234529	121238356	A530020G20Rik	+	3827	33994
chr3	121286593	121289136	2543	chr3	121234529	121238356	A530020G20Rik	+	3827	48237
chr3	122024674	122026128	1454	chr3	121996503	121996621	Mir760	-	118	28053
chr3	122036409	122038384	1975	chr3	121996503	121996621	Mir760	-	118	39788
chr3	122042264	122043984	1720	chr3	121996503	121996621	Mir760	-	118	45643
chr3	122080197	122082135	1938	chr3	122122698	122233098	Bcar3	+	110400	40563
chr3	122092785	122095325	2540	chr3	122122698	122233098	Bcar3	+	110400	27373
chr3	122096608	122097687	1079	chr3	122122698	122233098	Bcar3	+	110400	25011
chr3	122099409	122103451	4042	chr3	122122698	122233098	Bcar3	+	110400	19247
chr3	122108327	122109812	1485	chr3	122122698	122233098	Bcar3	+	110400	12886
chr3	122114385	122117421	3036	chr3	122122698	122233098	Bcar3	+	110400	5277
chr3	127616413	127617993	1580	chr3	127572606	127599241	5730508B09Rik	-	26635	17172
chr3	127634759	127636535	1776	chr3	127572606	127599241	5730508B09Rik	-	26635	35518
chr3	130417570	130418633	1063	chr3	130398839	130412362	Ostc	-	13523	5208
chr3	130422338	130423508	1170	chr3	130429749	130433316	Rpl34	-	3567	6241
chr3	130463635	130465165	1530	chr3	130429749	130433316	Rpl34	-	3567	30319
chr3	130499276	130500801	1525	chr3	130429749	130433316	Rpl34	-	3567	65960
chr3	130506709	130508546	1837	chr3	130573867	130573994	SNORA61	-	127	65321
chr3	130520879	130522564	1685	chr3	130573867	130573994	SNORA61	-	127	51303
chr3	130534086	130535933	1847	chr3	130573867	130573994	SNORA61	-	127	37934
chr3	130556062	130557062	1000	chr3	130573867	130573994	SNORA61	-	127	16805
chr3	130602629	130603677	1048	chr3	130573867	130573994	SNORA61	-	127	28635
chr3	130721714	130722933	1219	chr3	130802466	130802754	AC114668.1	+	288	79533
chr3	130787602	130788712	1110	chr3	130802466	130802754	AC114668.1	+	288	13754
chr3	133245123	133246316	1193	chr3	133251370	133251501	SNORA17	-	131	5054
chr3	133263142	133264470	1328	chr3	133251370	133251501	SNORA17	-	131	11641
chr3	133285789	133290780	4991	chr3	133251370	133251501	SNORA17	-	131	34288
chr3	133313562	133316479	2917	chr3	133251370	133251501	SNORA17	-	131	62061
chr3	133322203	133323947	1744	chr3	133251370	133251501	SNORA17	-	131	70702
chr3	133347088	133348754	1666	chr3	133251370	133251501	SNORA17	-	131	95587
chr3	133373490	133377424	3934	chr3	133251370	133251501	SNORA17	-	131	121989
chr3	133411436	133413163	1727	chr3	133251370	133251501	SNORA17	-	131	159935
chr3	133417145	133418185	1040	chr3	133251370	133251501	SNORA17	-	131	165644
chr3	133420821	133422479	1658	chr3	133251370	133251501	SNORA17	-	131	169320
chr3	135362174	135363878	1704	chr3	135247619	135354511	Nfkb1	-	106892	7663
chr3	135373259	135374348	1089	chr3	135390302	135391702	Gm9799	+	1400	15954
chr3	135376344	135378953	2609	chr3	135390302	135391702	Gm9799	+	1400	11349
chr3	135380699	135382569	1870	chr3	135390302	135391702	Gm9799	+	1400	7733
chr3	135397439	135398439	1000	chr3	135390302	135391702	Gm9799	+	1400	5737
chr3	136009402	136013670	4268	chr3	135716327	135989030	Bank1	-	272703	20372
chr3	136042044	136044428	2384	chr3	135716327	135989030	Bank1	-	272703	53014
chr3	136950711	136951711	1000	chr3	137004031	137095149	Emcn	+	91118	52320
chr3	136955793	136956865	1072	chr3	137004031	137095149	Emcn	+	91118	47166
chr3	137495420	137497260	1840	chr3	137527451	137529886	H2afz	+	2435	30191
chr3	137664520	137665991	1471	chr3	137593971	137644509	Dapp1	-	50538	20011
chr3	137703928	137704928	1000	chr3	137711725	137730352	Gm5105	-	18627	6797
chr3	143309570	143310637	1067	chr3	143337907	143338031	SNORA4	+	124	27270
chr3	143348180	143349714	1534	chr3	143337907	143338031	SNORA4	+	124	10149
chr3	143691885	143692949	1064	chr3	143851494	143868184	Lmo4	-	16690	158545
chr3	144043560	144044602	1042	chr3	144094067	144233145	Hs2st1	-	139078	49465
chr3	145693022	145694022	1000	chr3	145650834	145684684	Syde2	+	33850	8338
chr3	148357706	148360732	3026	chr3	148478550	148652280	Lphn2	-	173730	117818
chr3	148389219	148390297	1078	chr3	148478550	148652280	Lphn2	-	173730	88253
chr3	148967436	148968905	1469	chr3	149003867	149003972	U6	-	105	34962
chr3	148988935	148990561	1626	chr3	149003867	149003972	U6	-	105	13306
chr3	149011843	149012968	1125	chr3	149003867	149003972	U6	-	105	7871
chr3	149056001	149057001	1000	chr3	149003867	149003972	U6	-	105	52029
chr3	149300010	149302333	2323	chr3	149003867	149003972	U6	-	105	296038
chr3	152852246	152853362	1116	chr3	152868369	153388026	St6galnac3	-	519657	15007
chr3	153618068	153622164	4096	chr3	153585321	153607596	Acadm	-	22275	10472
chr3	157545147	157548993	3846	chr3	157557212	157588041	Cth	-	30829	8219
chr3	157601094	157602094	1000	chr3	157610378	157670288	Ankrd13c	+	59910	8284
chr3	5820689	5821689	1000	chr3	5560188	5576239	Pxmp3	-	16051	244450
chr3	9853010	9854010	1000	chr3	9687479	9833679	Pag1	-	146200	19331
chr3	9865227	9866360	1133	chr3	9687479	9833679	Pag1	-	146200	31548
chr3	14673678	14674696	1018	chr3	14641727	14663002	Car13	+	21275	10676
chr3	15229252	15230404	1152	chr3	15296551	15332302	Gm9733	-	35751	66147
chr3	15275923	15276923	1000	chr3	15296551	15332302	Gm9733	-	35751	19628
chr3	15283628	15284899	1271	chr3	15296551	15332302	Gm9733	-	35751	11652
chr3	15284940	15285940	1000	chr3	15296551	15332302	Gm9733	-	35751	10611
chr3	21851802	21852928	1126	chr3	21975574	22115516	Tbl1xr1	+	139942	122646
chr3	21860652	21861705	1053	chr3	21975574	22115516	Tbl1xr1	+	139942	113869
chr3	38136405	38137405	1000	chr3	38166760	38167006	AC162799.1	-	246	29355
chr3	50709920	50710920	1000	chr3	50642503	50642637	SNORA17	-	134	67283
chr3	50999227	51000227	1000	chr3	51028369	51055566	Ccrn4l	+	27197	28142
chr3	51162291	51163532	1241	chr3	51059153	51144580	Elf2	-	85427	17711
chr3	51440159	51442094	1935	chr3	51464282	51486597	Mgst2	+	22315	22188
chr3	52247808	52248863	1055	chr3	52072259	52154031	Foxo1	+	81772	93777
chr3	52601639	52602733	1094	chr3	52526571	52526677	U6	-	106	74962
chr3	52758796	52759796	1000	chr3	52786045	52821145	Cog6	-	35100	26249
chr3	65390152	65391307	1155	chr3	65332332	65359067	Tiparp	+	26735	31085
chr3	65462679	65463717	1038	chr3	65470150	65635084	Lekr1	+	164934	6433
chr3	65779484	65780484	1000	chr3	65750073	65762171	Ccnl1	-	12098	17313
chr3	68450614	68451614	1000	chr3	67868864	68430404	Schip1	+	561540	20210
chr3	68512892	68513892	1000	chr3	68494566	68502469	Il12a	+	7903	10423
chr3	68587175	68588307	1132	chr3	68537059	68541999	Gm10040	+	4940	45176
chr3	69093533	69095118	1585	chr3	69120783	69364724	Ppm1l	+	243941	25665
chr3	69503565	69504577	1012	chr3	69489389	69489502	5S_rRNA	+	113	14063
chr3	69558562	69559662	1100	chr3	69525907	69552964	Nmd3	+	27057	5598
chr3	83615768	83617291	1523	chr3	83577775	83593878	Gm16790	-	16103	21890
chr3	84138193	84139463	1270	chr3	83964361	84109368	Trim2	-	145007	28825
chr3	85952505	85953525	1020	chr3	85941862	85946624	Rps3a	-	4762	5881
chr3	87212533	87214374	1841	chr3	87180309	87196055	Fcrl1	+	15746	16478
chr3	87312155	87313673	1518	chr3	87329329	87344078	Etv3	+	14749	15656
chr3	87319709	87320709	1000	chr3	87329329	87344078	Etv3	+	14749	8620
chr3	87353781	87354781	1000	chr3	87329329	87344078	Etv3	+	14749	9703
chr3	88481494	88482494	1000	chr3	88489716	88516855	2810403A07Rik	+	27139	7222
chr3	90127038	90128038	1000	chr3	90145576	90162042	Gatad2b	+	16466	17538
chr3	95449078	95450151	1073	chr3	95462643	95467099	Mcl1	+	4456	12492
chr3	95454457	95455717	1260	chr3	95462643	95467099	Mcl1	+	4456	6926
chr3	95776115	95777245	1130	chr3	95792352	95799924	Plekho1	-	7572	15107
chr3	96137578	96138607	1029	chr3	96132348	96132513	U1	+	165	5065
chr3	97484579	97486281	1702	chr3	97477641	97478617	Gm17651	-	976	5962
chr3	97797905	97799207	1302	chr3	97817461	97954290	Notch2	+	136829	18254
chr3	97808891	97810276	1385	chr3	97817461	97954290	Notch2	+	136829	7185
chr3	100122373	100124186	1813	chr3	100107211	100107287	SNORD81	+	76	15086
chr3	100169261	100170261	1000	chr3	100217483	100218483	Gm12464	+	1000	47222
chr3	100496002	100497061	1059	chr3	100366130	100489426	Man1a2	-	123296	6576
chr3	101454498	101456335	1837	chr3	101380142	101408586	Atp1a1	-	28444	45912
chr3	101603829	101605208	1379	chr3	101616999	101652882	Mab21l3	-	35883	11791
chr3	103010300	103011391	1091	chr3	103002149	103002898	2410024N13Rik	-	749	7402
chr3	106678723	106679723	1000	chr3	106624474	106625500	Olfr266	-	1026	53223
chr3	106870181	106871267	1086	chr3	106842422	106854070	AI504432	+	11648	16111
chr3	106879970	106882470	2500	chr3	106893880	106901319	A930002I21Rik	+	7439	11410
chr3	108854471	108855471	1000	chr3	108773915	108830525	Fam102b	-	56610	23946
chr3	109126588	109127588	1000	chr3	109143571	109488616	Vav3	+	345045	15983
chr3	115376170	115377170	1000	chr3	115413351	115417973	S1pr1	-	4622	36181
chr3	115577585	115579084	1499	chr3	115590740	115591048	A930005H10Rik	-	308	11656
chr3	116138988	116140166	1178	chr3	116151307	116151482	U1	-	175	11141
chr3	116564224	116565282	1058	chr3	116581145	116606668	Frrs1	+	25523	15863
chr3	121273560	121274764	1204	chr3	121234529	121238356	A530020G20Rik	+	3827	35204
chr3	121303307	121304403	1096	chr3	121340063	121346403	A730020M07Rik	-	6340	35660
chr3	121575960	121576960	1000	chr3	121461827	121518220	Abcd3	-	56393	57740
chr3	122075099	122076851	1752	chr3	122122698	122233098	Bcar3	+	110400	45847
chr3	129226615	129227615	1000	chr3	129235304	129341413	Elovl6	+	106109	7689
chr3	130512811	130513992	1181	chr3	130573867	130573994	SNORA61	-	127	59875
chr3	133482087	133483087	1000	chr3	133618437	133903500	Gm2078	-	285063	135350
chr3	135374844	135375844	1000	chr3	135390302	135391702	Gm9799	+	1400	14458
chr3	136951769	136953413	1644	chr3	137004031	137095149	Emcn	+	91118	50618
chr3	137273567	137274712	1145	chr3	137284438	137284557	AC140486.1	+	119	9726
chr3	137654147	137656099	1952	chr3	137593971	137644509	Dapp1	-	50538	9638
chr3	143690702	143691868	1166	chr3	143851494	143868184	Lmo4	-	16690	159626
chr3	143894512	143896687	2175	chr3	143851494	143868184	Lmo4	-	16690	26328
chr3	145631892	145633128	1236	chr3	145650834	145684684	Syde2	+	33850	17706
chr3	145990859	145991859	1000	chr3	145883925	145949178	Lpar3	+	65253	41681
chr3	148154304	148155304	1000	chr3	148017051	148017182	SNORA17	-	131	137122
chr4	3553260	3556003	2743	chr4	3546336	3546462	SNORA18	+	126	6798
chr4	3566873	3567997	1124	chr4	3583655	3590255	2210414B05Rik	+	6600	15658
chr4	3573587	3574617	1030	chr4	3583655	3590255	2210414B05Rik	+	6600	9038
chr4	3750666	3752438	1772	chr4	3758481	3762812	Rps20	-	4331	6043
chr4	4833668	4834668	1000	chr4	4905654	4906021	Gm11779	-	367	70986
chr4	7141257	7142615	1358	chr4	6966194	6966661	Gm11804	-	467	174596
chr4	7381793	7382815	1022	chr4	7487835	7500948	8430436N08Rik	+	13113	105020
chr4	7839031	7840878	1847	chr4	7748063	7748194	SNORA17	+	131	90837
chr4	7887057	7889904	2847	chr4	7748063	7748194	SNORA17	+	131	138863
chr4	7959558	7962269	2711	chr4	8045767	8046883	Gm11800	+	1116	83498
chr4	8450016	8451016	1000	chr4	8462791	8534925	Rab2a	+	72134	11775
chr4	8573977	8575800	1823	chr4	8599780	8600729	Gm11809	-	949	23980
chr4	8824641	8826216	1575	chr4	8617553	8794806	Chd7	+	177253	29835
chr4	8839797	8840880	1083	chr4	8868406	8868803	Rps18-ps2	+	397	27526
chr4	8848727	8849842	1115	chr4	8868406	8868803	Rps18-ps2	+	397	18564
chr4	8852715	8854809	2094	chr4	8868406	8868803	Rps18-ps2	+	397	13597
chr4	8855076	8856330	1254	chr4	8868406	8868803	Rps18-ps2	+	397	12076
chr4	8954806	8956670	1864	chr4	8868406	8868803	Rps18-ps2	+	397	86003
chr4	9008697	9009697	1000	chr4	9137150	9137255	U6	+	105	127453
chr4	9042143	9043836	1693	chr4	9137150	9137255	U6	+	105	93314
chr4	10284036	10285036	1000	chr4	10365962	10366890	Gm11814	-	928	80926
chr4	10845451	10846551	1100	chr4	10801645	10826572	2610301B20Rik	+	24927	18879
chr4	10850268	10851268	1000	chr4	10873755	10874240	Gm11828	+	485	22487
chr4	10888589	10890641	2052	chr4	10873755	10874240	Gm11828	+	485	14349
chr4	10891306	10893147	1841	chr4	10873755	10874240	Gm11828	+	485	17066
chr4	10903754	10904754	1000	chr4	10915809	10935074	Plekhf2	-	19265	11055
chr4	10942990	10944502	1512	chr4	10915809	10935074	Plekhf2	-	19265	7916
chr4	10953305	10954305	1000	chr4	10915809	10935074	Plekhf2	-	19265	18231
chr4	11015129	11017193	2064	chr4	10978192	11003352	2310030N02Rik	-	25160	11777
chr4	11599498	11602135	2637	chr4	11576794	11577646	Gm11833	-	852	21852
chr4	11610031	11611031	1000	chr4	11631604	11641899	Gem	+	10295	20573
chr4	11648022	11649630	1608	chr4	11631604	11641899	Gem	+	10295	6123
chr4	11651259	11653435	2176	chr4	11631604	11641899	Gem	+	10295	9360
chr4	15997810	15999431	1621	chr4	15981421	15981485	U7	+	64	16325
chr4	16038881	16040655	1774	chr4	16047906	16048035	Gm11874	-	129	7251
chr4	25971449	25972449	1000	chr4	25867512	25867617	U6	+	105	103832
chr4	32024189	32025189	1000	chr4	32051072	32110442	Map3k7	+	59370	25883
chr4	32027682	32030413	2731	chr4	32051072	32110442	Map3k7	+	59370	20659
chr4	32250944	32252318	1374	chr4	32236761	32237197	Gm11928	+	436	13747
chr4	32266040	32267879	1839	chr4	32294123	32295067	Gm11929	+	944	26244
chr4	32306143	32307659	1516	chr4	32294123	32295067	Gm11929	+	944	11076
chr4	32315623	32317035	1412	chr4	32325779	32673083	Bach2	+	347304	8744
chr4	33673215	33675565	2350	chr4	33701807	33702113	Gm12398	-	306	26242
chr4	40728063	40729157	1094	chr4	40722292	40722597	Gm12396	-	305	5466
chr4	40740956	40742294	1338	chr4	40751635	40801038	B4galt1	-	49403	9341
chr4	40822179	40823185	1006	chr4	40751635	40801038	B4galt1	-	49403	21141
chr4	40829684	40831782	2098	chr4	40859774	40860388	Gm12397	-	614	27992
chr4	40852214	40853842	1628	chr4	40859774	40860388	Gm12397	-	614	5932
chr4	41010965	41011965	1000	chr4	40997253	40997359	U6	+	106	13606
chr4	43478415	43479711	1296	chr4	43459334	43467500	Cd72	-	8166	10915
chr4	47335086	47336086	1000	chr4	47221033	47326039	Col15a1	+	105006	9047
chr4	47614375	47617659	3284	chr4	47487530	47496114	Sec61b	+	8584	118261
chr4	47755981	47756981	1000	chr4	47933627	47933769	SNORA17	+	142	176646
chr4	47811452	47812883	1431	chr4	47933627	47933769	SNORA17	+	142	120744
chr4	48024355	48026068	1713	chr4	48009328	48011133	Gm12434	+	1805	13222
chr4	48121420	48122420	1000	chr4	48137787	48199379	Stx17	+	61592	15367
chr4	50381175	50383713	2538	chr4	50299618	50299749	SNORA17	+	131	81426
chr4	53208306	53209306	1000	chr4	53217938	53230729	4930412L05Rik	-	12791	8632
chr4	53290250	53291988	1738	chr4	53275604	53283104	AI427809	-	7500	7146
chr4	53424296	53426802	2506	chr4	53414820	53416902	Gm12496	-	2082	7394
chr4	53811490	53813285	1795	chr4	53803942	53804328	Rps15a-ps8	-	386	7162
chr4	53960330	53961962	1632	chr4	53918568	53918692	SNORA17	+	124	41638
chr4	54493974	54495309	1335	chr4	54481205	54481483	AL772349.1	+	278	12491
chr4	54539846	54543238	3392	chr4	54577495	54578015	Tpt1-ps2	+	520	34257
chr4	55339944	55342166	2222	chr4	55362915	55405109	Rad23b	+	42194	20749
chr4	55454478	55457520	3042	chr4	55463556	55478686	Gm12510	-	15130	6036
chr4	55500101	55502536	2435	chr4	55481897	55482031	SNORA17	-	134	18070
chr4	55527404	55528404	1000	chr4	55521166	55521580	Gm12507	+	414	5824
chr4	55663786	55664905	1119	chr4	55618021	55649773	Gm12506	+	31752	14013
chr4	55836345	55837345	1000	chr4	55981895	56006611	Gm12519	-	24716	144550
chr4	56092947	56094793	1846	chr4	56175812	56176127	Gm12520	+	315	81019
chr4	59251286	59253063	1777	chr4	59202129	59235705	Ugcg	+	33576	15581
chr4	59285934	59288007	2073	chr4	59272923	59276141	Gm12596	+	3218	9793
chr4	59288173	59289370	1197	chr4	59272923	59276141	Gm12596	+	3218	12032
chr4	59298508	59300559	2051	chr4	59272923	59276141	Gm12596	+	3218	22367
chr4	59307360	59308936	1576	chr4	59327555	59451505	Susd1	-	123950	18619
chr4	63069696	63070718	1022	chr4	63028159	63064479	Akna	-	36320	5217
chr4	63335180	63337343	2163	chr4	63323389	63324410	Gm11214	-	1021	10770
chr4	63362253	63364402	2149	chr4	63385637	63406147	Tnfsf15	-	20510	21235
chr4	63416431	63417796	1365	chr4	63385637	63406147	Tnfsf15	-	20510	10284
chr4	63418066	63419328	1262	chr4	63385637	63406147	Tnfsf15	-	20510	11919
chr4	63425261	63426540	1279	chr4	63385637	63406147	Tnfsf15	-	20510	19114
chr4	63432481	63434567	2086	chr4	63385637	63406147	Tnfsf15	-	20510	26334
chr4	63529424	63530994	1570	chr4	63492342	63522381	Tnfsf8	-	30039	7043
chr4	63535432	63537032	1600	chr4	63492342	63522381	Tnfsf8	-	30039	13051
chr4	63589084	63590084	1000	chr4	63620819	63681760	Tnc	-	60941	30735
chr4	63594849	63598073	3224	chr4	63620819	63681760	Tnc	-	60941	22746
chr4	63598493	63601380	2887	chr4	63620819	63681760	Tnc	-	60941	19439
chr4	63601799	63605289	3490	chr4	63620819	63681760	Tnc	-	60941	15530
chr4	63608003	63609546	1543	chr4	63620819	63681760	Tnc	-	60941	11273
chr4	71149328	71150406	1078	chr4	71031729	71032239	Rps18-ps1	-	510	117089
chr4	72085522	72086522	1000	chr4	72203700	72204032	Gm11235	+	332	117178
chr4	74907764	74909674	1910	chr4	74923258	74924209	3110001D03Rik	-	951	13584
chr4	81787171	81789399	2228	chr4	81711335	81748712	Gm5860	+	37377	38459
chr4	82999897	83000897	1000	chr4	83024221	83036572	Gm11413	-	12351	23324
chr4	83157699	83159259	1560	chr4	83151051	83151458	Gm10154	-	407	6241
chr4	87013853	87014853	1000	chr4	87078176	87078240	AL806517.1	+	64	63323
chr4	87327399	87330099	2700	chr4	87415829	87679268	Mllt3	-	263439	85730
chr4	87724836	87725912	1076	chr4	87740533	88056915	BC057079	+	316382	14621
chr4	87726874	87727991	1117	chr4	87740533	88056915	BC057079	+	316382	12542
chr4	88196002	88197133	1131	chr4	88203577	88204149	Gm12597	-	572	6444
chr4	88840665	88842537	1872	chr4	88828885	88829024	SNORA17	-	139	11641
chr4	89015623	89016623	1000	chr4	89048648	89066571	Gm12609	+	17923	32025
chr4	89032007	89033007	1000	chr4	89048648	89066571	Gm12609	+	17923	15641
chr4	89038487	89039953	1466	chr4	89048648	89066571	Gm12609	+	17923	8695
chr4	89190835	89191835	1000	chr4	89088539	89130178	Gm12610	+	41639	60657
chr4	89195930	89196930	1000	chr4	89088539	89130178	Gm12610	+	41639	65752
chr4	89541668	89542731	1063	chr4	89346127	89361463	Dmrta1	+	15336	180205
chr4	92608413	92609413	1000	chr4	92636935	92637427	Gm12639	-	492	27522
chr4	94896394	94898297	1903	chr4	94860004	94876418	Gm12708	+	16414	19976
chr4	94944209	94945750	1541	chr4	94860004	94876418	Gm12708	+	16414	67791
chr4	94967919	94968919	1000	chr4	94860004	94876418	Gm12708	+	16414	91501
chr4	94969382	94970494	1112	chr4	94860004	94876418	Gm12708	+	16414	92964
chr4	95051754	95053498	1744	chr4	95131415	95154085	Gm830	-	22670	77917
chr4	102290667	102292284	1617	chr4	101760148	102279864	Pde4b	+	519716	10803
chr4	102292933	102294216	1283	chr4	101760148	102279864	Pde4b	+	519716	13069
chr4	102294242	102299224	4982	chr4	101760148	102279864	Pde4b	+	519716	14378
chr4	102301771	102305116	3345	chr4	101760148	102279864	Pde4b	+	519716	21907
chr4	102318447	102320655	2208	chr4	101760148	102279864	Pde4b	+	519716	38583
chr4	102328982	102329982	1000	chr4	101760148	102279864	Pde4b	+	519716	49118
chr4	104924692	104927299	2607	chr4	104829952	104905369	Ppap2b	+	75417	19323
chr4	104935509	104936509	1000	chr4	104829952	104905369	Ppap2b	+	75417	30140
chr4	104957319	104959565	2246	chr4	104829952	104905369	Ppap2b	+	75417	51950
chr4	104962118	104965144	3026	chr4	104829952	104905369	Ppap2b	+	75417	56749
chr4	106201816	106202865	1049	chr4	106171421	106178940	Tmem61	-	7519	22876
chr4	114324398	114326056	1658	chr4	114353409	114360200	Gm12829	+	6791	27353
chr4	118754790	118755790	1000	chr4	118727395	118741716	Gm12866	-	14321	13074
chr4	119341806	119342880	1074	chr4	119329212	119331559	Guca2b	-	2347	10247
chr4	120316465	120317465	1000	chr4	120288445	120295287	Gm12860	+	6842	21178
chr4	120700971	120702312	1341	chr4	120711990	120727927	Col9a2	+	15937	9678
chr4	122568935	122569935	1000	chr4	122536290	122563299	Cap1	-	27009	5636
chr4	122613489	122617531	4042	chr4	122624093	122638431	Mfsd2a	-	14338	6562
chr4	122982761	122983761	1000	chr4	122989888	123020495	Bmp8a	-	30607	6127
chr4	125639354	125640431	1077	chr4	125565095	125599661	2610028E06Rik	-	34566	39693
chr4	125678427	125679975	1548	chr4	125701794	125722219	Csf3r	+	20425	21819
chr4	125680384	125681534	1150	chr4	125701794	125722219	Csf3r	+	20425	20260
chr4	128304198	128305448	1250	chr4	128292690	128295863	Tlr12	-	3173	8335
chr4	128647745	128649342	1597	chr4	128607477	128639686	Adc	-	32209	8059
chr4	128650266	128652382	2116	chr4	128607477	128639686	Adc	-	32209	10580
chr4	128657362	128659644	2282	chr4	128669202	128688773	Ak2	+	19571	9558
chr4	128700810	128702903	2093	chr4	128669202	128688773	Ak2	+	19571	12037
chr4	128709235	128710863	1628	chr4	128727341	128735227	1700086P04Rik	-	7886	16478
chr4	129083317	129084317	1000	chr4	129103009	129118097	Zbtb8b	-	15088	18692
chr4	129431076	129432486	1410	chr4	129438872	129439160	Gm12967	-	288	6386
chr4	129459059	129460548	1489	chr4	129438872	129439160	Gm12967	-	288	19899
chr4	129465337	129466587	1250	chr4	129488463	129527247	Ptp4a2	+	38784	21876
chr4	129470479	129473441	2962	chr4	129488463	129527247	Ptp4a2	+	38784	15022
chr4	129480161	129481161	1000	chr4	129488463	129527247	Ptp4a2	+	38784	7302
chr4	129554246	129557260	3014	chr4	129572817	129572968	U1	+	151	15557
chr4	129559177	129561966	2789	chr4	129572817	129572968	U1	+	151	10851
chr4	129603373	129604608	1235	chr4	129583460	129597031	E330017L17Rik	+	13571	6342
chr4	129605046	129606210	1164	chr4	129583460	129597031	E330017L17Rik	+	13571	8015
chr4	130452347	130454639	2292	chr4	130469040	130492056	Laptm5	+	23016	14401
chr4	130455233	130456696	1463	chr4	130469040	130492056	Laptm5	+	23016	12344
chr4	130458123	130459123	1000	chr4	130469040	130492056	Laptm5	+	23016	9917
chr4	130460008	130461373	1365	chr4	130469040	130492056	Laptm5	+	23016	7667
chr4	130946669	130949287	2618	chr4	131043112	131061442	Gm831	+	18330	93825
chr4	130949852	130951625	1773	chr4	131043112	131061442	Gm831	+	18330	91487
chr4	132371802	132372802	1000	chr4	132382844	132399084	Ppp1r8	-	16240	10042
chr4	132499606	132500611	1005	chr4	132487126	132487232	U6	-	106	12374
chr4	132514849	132517236	2387	chr4	132530010	132557825	Fgr	+	27815	12774
chr4	132673290	132674515	1225	chr4	132686420	132755671	Wasf2	+	69251	11905
chr4	133330012	133331212	1200	chr4	133234923	133312684	Arid1a	-	77761	17328
chr4	133359570	133361257	1687	chr4	133353497	133353634	U4	-	137	5936
chr4	133392375	133394326	1951	chr4	133403205	133443712	Rps6ka1	-	40507	8879
chr4	133396950	133397980	1030	chr4	133403205	133443712	Rps6ka1	-	40507	5225
chr4	133458633	133460219	1586	chr4	133403205	133443712	Rps6ka1	-	40507	14921
chr4	133465694	133467795	2101	chr4	133403205	133443712	Rps6ka1	-	40507	21982
chr4	133484298	133485761	1463	chr4	133520653	133524565	Hmgn2	-	3912	34892
chr4	133597016	133600065	3049	chr4	133609753	133614911	Gm13060	+	5158	9688
chr4	133855893	133856893	1000	chr4	133830917	133843810	Pdik1l	-	12893	12083
chr4	134501700	134502764	1064	chr4	134486813	134493463	Syf2	+	6650	8237
chr4	134511594	134512594	1000	chr4	134486813	134493463	Syf2	+	6650	18131
chr4	134518772	134519845	1073	chr4	134486813	134493463	Syf2	+	6650	25309
chr4	134622480	134623579	1099	chr4	134674136	134676362	Gm16225	-	2226	50557
chr4	134635345	134637308	1963	chr4	134674136	134676362	Gm16225	-	2226	36828
chr4	134641431	134642521	1090	chr4	134674136	134676362	Gm16225	-	2226	31615
chr4	134654077	134655077	1000	chr4	134674136	134676362	Gm16225	-	2226	19059
chr4	134658096	134659751	1655	chr4	134674136	134676362	Gm16225	-	2226	14385
chr4	134753249	134754884	1635	chr4	134769884	134828729	Clic4	-	58845	15000
chr4	134758315	134760351	2036	chr4	134769884	134828729	Clic4	-	58845	9533
chr4	134761013	134763144	2131	chr4	134769884	134828729	Clic4	-	58845	6740
chr4	135439156	135440728	1572	chr4	135447179	135447392	Gm13006	-	213	6451
chr4	135662124	135663735	1611	chr4	135693411	135693513	U6	+	102	29676
chr4	135665727	135666938	1211	chr4	135693411	135693513	U6	+	102	26473
chr4	135677930	135679392	1462	chr4	135693411	135693513	U6	+	102	14019
chr4	135682837	135684756	1919	chr4	135693411	135693513	U6	+	102	8655
chr4	136640777	136641777	1000	chr4	136672624	136673497	1700037C06Rik	-	873	30847
chr4	136920823	136922656	1833	chr4	136875611	136913635	Cdc42	-	38024	7188
chr4	136922758	136924229	1471	chr4	136875611	136913635	Cdc42	-	38024	9123
chr4	136936643	136937701	1058	chr4	136951208	136951623	Gm13004	+	415	13507
chr4	138724661	138725668	1007	chr4	138731320	138736570	Gm16287	-	5250	5652
chr4	141114439	141116293	1854	chr4	141102104	141103807	B330016D10Rik	+	1703	10632
chr4	141290225	141291301	1076	chr4	141233464	141279334	Ddi2	-	45870	10891
chr4	142808725	142809986	1261	chr4	142697294	142802898	Prdm2	-	105604	5827
chr4	144843555	144845333	1778	chr4	144803366	144836773	Tnfrsf1b	-	33407	6782
chr4	144847482	144848482	1000	chr4	144857040	144905067	Tnfrsf8	-	48027	8558
chr4	144927636	144931256	3620	chr4	144857040	144905067	Tnfrsf8	-	48027	22569
chr4	144931516	144935327	3811	chr4	144857040	144905067	Tnfrsf8	-	48027	26449
chr4	144943198	144946526	3328	chr4	144980846	144981563	Gm13024	+	717	34320
chr4	144950514	144951794	1280	chr4	144980846	144981563	Gm13024	+	717	29052
chr4	148056917	148058680	1763	chr4	148017426	148045681	Gm572	+	28255	11236
chr4	149227583	149231021	3438	chr4	149240635	149240742	snoZ178	-	107	9614
chr4	149585689	149587703	2014	chr4	149561124	149575441	Car6	-	14317	10248
chr4	149642823	149643823	1000	chr4	149655755	149996075	Rere	+	340320	11932
chr4	150172112	150174468	2356	chr4	150199842	150213684	Gm13049	+	13842	25374
chr4	150182020	150183755	1735	chr4	150199842	150213684	Gm13049	+	13842	16087
chr4	154287183	154288613	1430	chr4	154296319	154302672	Tnfrsf14	-	6353	7706
chr4	154288637	154290211	1574	chr4	154296319	154302672	Tnfrsf14	-	6353	6108
chr4	154316872	154318736	1864	chr4	154296319	154302672	Tnfrsf14	-	6353	14200
chr4	154608336	154610328	1992	chr4	154528184	154596701	Ski	-	68517	11635
chr4	154610535	154611535	1000	chr4	154623911	154630793	2610002J02Rik	+	6882	12376
chr4	154856632	154858071	1439	chr4	154865470	154933378	Gnb1	+	67908	7399
chr4	3575403	3576555	1152	chr4	3583655	3590255	2210414B05Rik	+	6600	7100
chr4	4834687	4835838	1151	chr4	4905654	4906021	Gm11779	-	367	69816
chr4	7332350	7333476	1126	chr4	7487835	7500948	8430436N08Rik	+	13113	154359
chr4	7919658	7920658	1000	chr4	8045767	8046883	Gm11800	+	1116	125109
chr4	8842686	8843686	1000	chr4	8868406	8868803	Rps18-ps2	+	397	24720
chr4	9060940	9061940	1000	chr4	9137150	9137255	U6	+	105	75210
chr4	10842682	10843758	1076	chr4	10801645	10826572	2610301B20Rik	+	24927	16110
chr4	10944656	10945656	1000	chr4	10915809	10935074	Plekhf2	-	19265	9582
chr4	16015437	16016652	1215	chr4	16047906	16048035	Gm11874	-	129	31254
chr4	16029196	16030196	1000	chr4	16047906	16048035	Gm11874	-	129	17710
chr4	25949144	25950144	1000	chr4	25867512	25867617	U6	+	105	81527
chr4	25972553	25973553	1000	chr4	25867512	25867617	U6	+	105	104936
chr4	32257341	32258575	1234	chr4	32236761	32237197	Gm11928	+	436	20144
chr4	40823667	40825534	1867	chr4	40751635	40801038	B4galt1	-	49403	22629
chr4	47759526	47760711	1185	chr4	47933627	47933769	SNORA17	+	142	172916
chr4	48747949	48749305	1356	chr4	48758387	48758722	Gm12438	-	335	9082
chr4	53880225	53881225	1000	chr4	53838917	53874891	Tmem38b	+	35974	5334
chr4	53962021	53963138	1117	chr4	53918568	53918692	SNORA17	+	124	43329
chr4	56099133	56100133	1000	chr4	56175812	56176127	Gm12520	+	315	75679
chr4	59458074	59459304	1230	chr4	59327555	59451505	Susd1	-	123950	6569
chr4	61909530	61910530	1000	chr4	61923596	61959445	Slc31a2	+	35849	13066
chr4	62399364	62400364	1000	chr4	62384550	62388571	Gm11211	-	4021	10793
chr4	63426710	63427710	1000	chr4	63385637	63406147	Tnfsf15	-	20510	20563
chr4	81811973	81812973	1000	chr4	81711335	81748712	Gm5860	+	37377	63261
chr4	88583831	88584831	1000	chr4	88556461	88556566	Mir31	-	105	27265
chr4	89016821	89018388	1567	chr4	89048648	89066571	Gm12609	+	17923	30260
chr4	89035720	89036720	1000	chr4	89048648	89066571	Gm12609	+	17923	11928
chr4	97198897	97199897	1000	chr4	97188119	97189023	Gm12696	-	904	9874
chr4	106500391	106501494	1103	chr4	106514366	106520525	Gm12746	-	6159	12872
chr4	107341010	107342010	1000	chr4	107348895	107356835	Dmrtb1	-	7940	6885
chr4	120696460	120697576	1116	chr4	120640922	120689852	Smap2	-	48930	6608
chr4	122488489	122489489	1000	chr4	122455397	122470992	Gm12873	-	15595	17497
chr4	122609672	122611496	1824	chr4	122603076	122603315	Gm12891	+	239	6357
chr4	125681555	125682555	1000	chr4	125701794	125722219	Csf3r	+	20425	19239
chr4	130179291	130180291	1000	chr4	130125705	130169623	Nkain1	+	43918	9668
chr4	132148770	132149922	1152	chr4	132119982	132138598	Ptafr	+	18616	10172
chr4	132501706	132502725	1019	chr4	132487126	132487232	U6	-	106	14474
chr4	133383576	133384576	1000	chr4	133372335	133373529	Gm12974	+	1194	10047
chr4	134289932	134290932	1000	chr4	134300650	134323939	Ldlrap1	-	23289	9718
chr4	134329253	134330253	1000	chr4	134300650	134323939	Ldlrap1	-	23289	5314
chr4	134628896	134630643	1747	chr4	134674136	134676362	Gm16225	-	2226	43493
chr4	135644729	135646570	1841	chr4	135630428	135630887	Gm13009	-	459	13842
chr4	135656173	135657257	1084	chr4	135630428	135630887	Gm13009	-	459	25286
chr4	136943633	136945175	1542	chr4	136951208	136951623	Gm13004	+	415	6033
chr4	138499540	138500540	1000	chr4	138523027	138524280	Rnf186	+	1253	22487
chr4	144913203	144914528	1325	chr4	144857040	144905067	Tnfrsf8	-	48027	8136
chr4	144926022	144927022	1000	chr4	144857040	144905067	Tnfrsf8	-	48027	20955
chr4	149414493	149415614	1121	chr4	149423122	149431085	Gm13067	+	7963	7508
chr4	154617157	154618397	1240	chr4	154623911	154630793	2610002J02Rik	+	6882	5514
chr4	154855548	154856548	1000	chr4	154865470	154933378	Gnb1	+	67908	8922
chr4	155444342	155445342	1000	chr4	155426824	155433911	Gm13648	-	7087	10431
chr4	155451504	155452504	1000	chr4	155426824	155433911	Gm13648	-	7087	17593
chr5	3300597	3301597	1000	chr5	3343893	3523218	Cdk6	+	179325	42296
chr5	4111795	4112795	1000	chr5	4081145	4104746	Cyp51	-	23601	7049
chr5	4122055	4123992	1937	chr5	4081145	4104746	Cyp51	-	23601	17309
chr5	7224072	7225072	1000	chr5	7177706	7177856	U12	-	150	46216
chr5	7828359	7831366	3007	chr5	7857108	7857847	Gm8802	+	739	25742
chr5	8760466	8762783	2317	chr5	8773577	8798523	Gm5106	-	24946	10794
chr5	9058857	9059857	1000	chr5	9100737	9118983	4930420K17Rik	+	18246	40880
chr5	9085021	9086595	1574	chr5	9100737	9118983	4930420K17Rik	+	18246	14142
chr5	9088252	9091634	3382	chr5	9100737	9118983	4930420K17Rik	+	18246	9103
chr5	17967953	17970878	2925	chr5	17770953	17866231	Gnai1	-	95278	101722
chr5	20254713	20255713	1000	chr5	20264481	20387942	Phtf2	-	123461	8768
chr5	20472530	20475148	2618	chr5	20398846	20457640	Rsbn1l	-	58794	14890
chr5	20636938	20637938	1000	chr5	20622901	20623019	SNORA40	-	118	13919
chr5	21956963	21958017	1054	chr5	21936149	21936261	n-R5s170	-	112	20702
chr5	22757153	22758153	1000	chr5	22841782	22843467	Gm17434	+	1685	83629
chr5	22761811	22762815	1004	chr5	22841782	22843467	Gm17434	+	1685	78967
chr5	22891292	22893962	2670	chr5	22937628	22939737	5031425E22Rik	-	2109	43666
chr5	22915601	22919472	3871	chr5	22937628	22939737	5031425E22Rik	-	2109	18156
chr5	22919766	22922595	2829	chr5	22937628	22939737	5031425E22Rik	-	2109	15033
chr5	22923169	22924702	1533	chr5	22937628	22939737	5031425E22Rik	-	2109	12926
chr5	23223528	23225005	1477	chr5	23216809	23216879	SNORD93	-	70	6649
chr5	23375981	23378269	2288	chr5	23356415	23360742	2700038G22Rik	+	4327	15239
chr5	23379595	23383501	3906	chr5	23356415	23360742	2700038G22Rik	+	4327	18853
chr5	23399288	23401382	2094	chr5	23421094	23536508	Fam126a	-	115414	19712
chr5	23544729	23545792	1063	chr5	23421094	23536508	Fam126a	-	115414	8221
chr5	23558107	23560471	2364	chr5	23421094	23536508	Fam126a	-	115414	21599
chr5	23566673	23567673	1000	chr5	23421094	23536508	Fam126a	-	115414	30165
chr5	23771465	23772986	1521	chr5	23762640	23762855	Gm9836	+	215	8610
chr5	30151312	30152514	1202	chr5	30062228	30113018	Dnajb6	+	50790	38294
chr5	30178857	30181904	3047	chr5	30062228	30113018	Dnajb6	+	50790	65839
chr5	30186948	30189875	2927	chr5	30062228	30113018	Dnajb6	+	50790	73930
chr5	30218835	30219835	1000	chr5	30062228	30113018	Dnajb6	+	50790	105817
chr5	30219994	30222465	2471	chr5	30062228	30113018	Dnajb6	+	50790	106976
chr5	30222953	30225206	2253	chr5	30062228	30113018	Dnajb6	+	50790	109935
chr5	30245817	30248320	2503	chr5	30339701	30346508	Il6	+	6807	91381
chr5	30272965	30274987	2022	chr5	30339701	30346508	Il6	+	6807	64714
chr5	30297567	30300630	3063	chr5	30339701	30346508	Il6	+	6807	39071
chr5	31878187	31879187	1000	chr5	31899308	32004345	Mrpl33	+	105037	20121
chr5	32405859	32407450	1591	chr5	32000057	32387335	Bre	+	387278	18524
chr5	32493522	32495668	2146	chr5	32477472	32477578	U6	+	106	15944
chr5	32715209	32716944	1735	chr5	32761347	32819806	Ppp1cb	+	58459	44403
chr5	33546116	33547143	1027	chr5	33556167	33560887	Spon2	-	4720	9024
chr5	33858073	33860081	2008	chr5	33773383	33776625	Nkx1-1	-	3242	81448
chr5	33876400	33877992	1592	chr5	33943000	33972284	Fam53a	-	29284	65008
chr5	34037538	34038815	1277	chr5	34000777	34021644	Tacc3	+	20867	15894
chr5	35508028	35509843	1815	chr5	35434139	35448415	Lrpap1	-	14276	59613
chr5	35510768	35512517	1749	chr5	35434139	35448415	Lrpap1	-	14276	62353
chr5	35703852	35704852	1000	chr5	35721801	35731125	E130018O15Rik	-	9324	16949
chr5	37103689	37105752	2063	chr5	36927437	37087263	D5Ertd579e	-	159826	16426
chr5	37117159	37118604	1445	chr5	37138613	37139918	Cno	-	1305	20009
chr5	39323652	39324652	1000	chr5	39097701	39268051	Clnk	-	170350	55601
chr5	39336684	39339783	3099	chr5	39097701	39268051	Clnk	-	170350	68633
chr5	43745667	43748248	2581	chr5	43624702	43680963	Cpeb2	+	56261	64704
chr5	43836879	43837879	1000	chr5	43852424	43852479	U7	+	55	14545
chr5	44243944	44245468	1524	chr5	44210125	44234510	Bst1	+	24385	9434
chr5	44245631	44246946	1315	chr5	44210125	44234510	Bst1	+	24385	11121
chr5	44355823	44356823	1000	chr5	44370104	44373001	Fgfbp1	-	2897	13281
chr5	44650116	44651904	1788	chr5	44566403	44617845	Tapt1	-	51442	32271
chr5	52244432	52245432	1000	chr5	51845488	51958964	Ppargc1a	-	113476	285468
chr5	52532478	52533478	1000	chr5	52541448	52581758	Dhx15	-	40310	7970
chr5	53025151	53026151	1000	chr5	53031326	53060968	Sepsecs	-	29642	5175
chr5	53301086	53302532	1446	chr5	53225254	53259036	Anapc4	+	33782	42050
chr5	53620935	53621935	1000	chr5	53498323	53604691	Sel1l3	-	106368	16244
chr5	53751692	53753741	2049	chr5	53737498	53737611	n-R5s172	-	113	14081
chr5	53768756	53771510	2754	chr5	53737498	53737611	n-R5s172	-	113	31145
chr5	53772254	53773254	1000	chr5	53737498	53737611	n-R5s172	-	113	34643
chr5	53784781	53786178	1397	chr5	53809812	53809921	5S_rRNA	+	109	23634
chr5	53792420	53793860	1440	chr5	53809812	53809921	5S_rRNA	+	109	15952
chr5	53800112	53802000	1888	chr5	53809812	53809921	5S_rRNA	+	109	7812
chr5	53881323	53882392	1069	chr5	53947018	54048684	Rbpj	+	101666	64626
chr5	53929966	53932352	2386	chr5	53947018	54048684	Rbpj	+	101666	14666
chr5	63169559	63170658	1099	chr5	62993684	63157437	Arap2	-	163753	12122
chr5	63285865	63286865	1000	chr5	63205062	63279547	Gm17384	+	74485	6318
chr5	64429112	64430144	1032	chr5	64393592	64393723	SNORA17	-	131	35389
chr5	64435671	64436671	1000	chr5	64393592	64393723	SNORA17	-	131	41948
chr5	64540629	64541720	1091	chr5	64535487	64535620	SNORA17	+	133	5009
chr5	64751076	64752115	1039	chr5	64550690	64742725	Tbc1d1	+	192035	8351
chr5	64755119	64756119	1000	chr5	64550690	64742725	Tbc1d1	+	192035	12394
chr5	64771452	64773579	2127	chr5	64550690	64742725	Tbc1d1	+	192035	28727
chr5	64780013	64784019	4006	chr5	64550690	64742725	Tbc1d1	+	192035	37288
chr5	64792305	64793321	1016	chr5	64550690	64742725	Tbc1d1	+	192035	49580
chr5	64801553	64802553	1000	chr5	64550690	64742725	Tbc1d1	+	192035	58828
chr5	64829262	64830512	1250	chr5	64550690	64742725	Tbc1d1	+	192035	86537
chr5	64846897	64849129	2232	chr5	64550690	64742725	Tbc1d1	+	192035	104172
chr5	64877929	64879739	1810	chr5	64550690	64742725	Tbc1d1	+	192035	135204
chr5	64896301	64897430	1129	chr5	65038872	65038988	AC122043.1	-	116	141442
chr5	65001038	65004313	3275	chr5	65038872	65038988	AC122043.1	-	116	34559
chr5	65016168	65017168	1000	chr5	65038872	65038988	AC122043.1	-	116	21704
chr5	65052468	65054230	1762	chr5	65038872	65038988	AC122043.1	-	116	13480
chr5	65067459	65069354	1895	chr5	65038872	65038988	AC122043.1	-	116	28471
chr5	65155145	65158177	3032	chr5	65194628	65221368	Klf3	+	26740	36451
chr5	65171811	65172865	1054	chr5	65194628	65221368	Klf3	+	26740	21763
chr5	65252045	65254012	1967	chr5	65194628	65221368	Klf3	+	26740	30677
chr5	65255861	65256861	1000	chr5	65194628	65221368	Klf3	+	26740	34493
chr5	65274026	65278916	4890	chr5	65316050	65324000	Tlr1	-	7950	37134
chr5	65298956	65301311	2355	chr5	65316050	65324000	Tlr1	-	7950	14739
chr5	65309527	65310615	1088	chr5	65316050	65324000	Tlr1	-	7950	5435
chr5	66114883	66117377	2494	chr5	66006499	66089095	Pds5a	-	82596	25788
chr5	66241645	66242882	1237	chr5	66254808	66287939	Rhoh	+	33131	11926
chr5	66245689	66249748	4059	chr5	66254808	66287939	Rhoh	+	33131	5060
chr5	67840700	67842261	1561	chr5	67818919	67829229	Gm16714	+	10310	11471
chr5	69124869	69128173	3304	chr5	68957409	68957535	SNORA17	-	126	167334
chr5	72573090	72574377	1287	chr5	72548239	72559422	Commd8	-	11183	13668
chr5	72574488	72576368	1880	chr5	72548239	72559422	Commd8	-	11183	15066
chr5	73656075	73657685	1610	chr5	73411561	73647857	Fryl	-	236296	8218
chr5	73670392	73673088	2696	chr5	73684033	73705316	Ociad1	+	21283	10945
chr5	73675017	73677121	2104	chr5	73684033	73705316	Ociad1	+	21283	6912
chr5	75462173	75463826	1653	chr5	75471489	75473918	Gsx2	+	2429	7663
chr5	76443960	76445268	1308	chr5	76402344	76402466	5S_rRNA	-	122	41494
chr5	77646001	77647001	1000	chr5	77634132	77640496	Spink2	-	6364	5505
chr5	77674643	77675719	1076	chr5	77694516	77715457	Rest	+	20941	18797
chr5	77680815	77682444	1629	chr5	77694516	77715457	Rest	+	20941	12072
chr5	77888714	77889815	1101	chr5	77940293	77940676	Pea15b	-	383	50478
chr5	88969159	88970159	1000	chr5	88949537	88956916	Igj	-	7379	12243
chr5	89780569	89782700	2131	chr5	89846549	89886790	Gc	-	40241	63849
chr5	90811461	90813022	1561	chr5	90796230	90797513	Gm9958	+	1283	13948
chr5	91170454	91172209	1755	chr5	91188325	91190651	Cxcl5	+	2326	16116
chr5	93684709	93685762	1053	chr5	93696283	93705257	Ccng2	+	8974	10521
chr5	96466007	96467007	1000	chr5	96499352	96593190	Cnot6l	-	93838	32345
chr5	96598954	96601688	2734	chr5	96499352	96593190	Cnot6l	-	93838	5764
chr5	96605943	96606989	1046	chr5	96499352	96593190	Cnot6l	-	93838	12753
chr5	97344371	97347013	2642	chr5	97336651	97336844	U2	+	193	7527
chr5	97349007	97352217	3210	chr5	97336651	97336844	U2	+	193	12163
chr5	97359457	97361203	1746	chr5	97336651	97336844	U2	+	193	22613
chr5	97377262	97378668	1406	chr5	97336651	97336844	U2	+	193	40418
chr5	97390671	97392354	1683	chr5	97426708	97520886	Bmp2k	+	94178	34354
chr5	97393102	97394158	1056	chr5	97426708	97520886	Bmp2k	+	94178	32550
chr5	97397329	97398460	1131	chr5	97426708	97520886	Bmp2k	+	94178	28248
chr5	97408192	97410244	2052	chr5	97426708	97520886	Bmp2k	+	94178	16464
chr5	98236207	98237207	1000	chr5	98313707	98459981	Antxr2	-	146274	76500
chr5	98243486	98245399	1913	chr5	98313707	98459981	Antxr2	-	146274	68308
chr5	99695265	99698182	2917	chr5	99646445	99681946	Rasgef1b	-	35501	13319
chr5	100334950	100336050	1100	chr5	100357302	100357400	U6	-	98	21252
chr5	101007011	101008673	1662	chr5	100982744	101001264	Plac8	-	18520	5747
chr5	101009262	101011994	2732	chr5	100982744	101001264	Plac8	-	18520	7998
chr5	101012342	101015751	3409	chr5	100982744	101001264	Plac8	-	18520	11078
chr5	101018978	101020347	1369	chr5	100982744	101001264	Plac8	-	18520	17714
chr5	101026268	101029711	3443	chr5	100982744	101001264	Plac8	-	18520	25004
chr5	101064038	101066686	2648	chr5	101083742	101104159	Coq2	-	20417	17056
chr5	101071940	101074072	2132	chr5	101083742	101104159	Coq2	-	20417	9670
chr5	101154860	101156068	1208	chr5	101108503	101148735	Hpse	-	40232	6125
chr5	101157159	101158281	1122	chr5	101108503	101148735	Hpse	-	40232	8424
chr5	101179298	101181118	1820	chr5	101191164	101227619	Helq	-	36455	10046
chr5	101181789	101182789	1000	chr5	101191164	101227619	Helq	-	36455	8375
chr5	103687472	103689782	2310	chr5	103336967	103640353	Mapk10	-	303386	47119
chr5	103762645	103766090	3445	chr5	103854211	104027378	Ptpn13	+	173167	88121
chr5	103789208	103790673	1465	chr5	103854211	104027378	Ptpn13	+	173167	63538
chr5	104780543	104781954	1411	chr5	104754348	104767630	Mepe	+	13282	12913
chr5	104786869	104787869	1000	chr5	104754348	104767630	Mepe	+	13282	19239
chr5	105286643	105289830	3187	chr5	105314891	105315145	Gm3209	-	254	25061
chr5	105573833	105576037	2204	chr5	105544786	105568605	Gbp4	-	23819	5228
chr5	105923359	105925464	2105	chr5	105844794	105915208	Lrrc8b	+	70414	8151
chr5	105928525	105930285	1760	chr5	105844794	105915208	Lrrc8b	+	70414	13317
chr5	106051306	106053170	1864	chr5	105948407	106042037	Lrrc8c	+	93630	9269
chr5	106054857	106056181	1324	chr5	105948407	106042037	Lrrc8c	+	93630	12820
chr5	106071517	106073194	1677	chr5	105948407	106042037	Lrrc8c	+	93630	29480
chr5	106083058	106084233	1175	chr5	105948407	106042037	Lrrc8c	+	93630	41021
chr5	106090370	106091845	1475	chr5	106128988	106261455	Lrrc8d	+	132467	37143
chr5	106112132	106116352	4220	chr5	106128988	106261455	Lrrc8d	+	132467	12636
chr5	107253923	107255104	1181	chr5	107269211	107355340	Hfm1	-	86129	14107
chr5	107442300	107443329	1029	chr5	107393341	107413451	Cdc7	+	20110	28849
chr5	107443499	107445151	1652	chr5	107393341	107413451	Cdc7	+	20110	30048
chr5	107516850	107517850	1000	chr5	107535589	107718648	Tgfbr3	-	183059	17739
chr5	108131528	108133771	2243	chr5	108145674	108155056	Gfi1	-	9382	11903
chr5	108167289	108168289	1000	chr5	108173814	108304126	Evi5	-	130312	5525
chr5	108674664	108675797	1133	chr5	108561933	108661966	Ccdc18	+	100033	12698
chr5	109977673	109978673	1000	chr5	109983730	109988012	Crlf2	-	4282	5057
chr5	110223975	110225702	1727	chr5	110186541	110186950	Gm8508	-	409	37025
chr5	110273388	110274430	1042	chr5	110351668	110352500	Gm16739	-	832	77238
chr5	110295351	110296401	1050	chr5	110351668	110352500	Gm16739	-	832	55267
chr5	110486368	110487502	1134	chr5	110475251	110475505	Gm17655	-	254	10863
chr5	111067505	111068505	1000	chr5	111077437	111082436	Noc4l	-	4999	8932
chr5	111937688	111939126	1438	chr5	111846382	111886053	Mn1	+	39671	51635
chr5	112270756	112272608	1852	chr5	112163304	112190745	E130006D01Rik	-	27441	80011
chr5	113609001	113610200	1199	chr5	113515343	113592371	2900026A02Rik	-	77028	16630
chr5	118803631	118804631	1000	chr5	118868736	118868827	AC132338.1	-	91	64105
chr5	118825343	118828388	3045	chr5	118868736	118868827	AC132338.1	-	91	40348
chr5	118830298	118831834	1536	chr5	118868736	118868827	AC132338.1	-	91	36902
chr5	118853770	118855696	1926	chr5	118868736	118868827	AC132338.1	-	91	13040
chr5	118914390	118916825	2435	chr5	118952849	118953326	Gm15754	+	477	36024
chr5	118927104	118929160	2056	chr5	118952849	118953326	Gm15754	+	477	23689
chr5	118932420	118934083	1663	chr5	118952849	118953326	Gm15754	+	477	18766
chr5	118944116	118945647	1531	chr5	118952849	118953326	Gm15754	+	477	7202
chr5	118962346	118965296	2950	chr5	118952849	118953326	Gm15754	+	477	9020
chr5	121556107	121557961	1854	chr5	121580542	121641406	Ptpn11	-	60864	22581
chr5	121560652	121562430	1778	chr5	121580542	121641406	Ptpn11	-	60864	18112
chr5	121563023	121565053	2030	chr5	121580542	121641406	Ptpn11	-	60864	15489
chr5	122594704	122597248	2544	chr5	122558049	122588966	Ccdc63	-	30917	5738
chr5	122724152	122725615	1463	chr5	122734374	122774290	Pptc7	+	39916	8759
chr5	123281751	123283485	1734	chr5	123237478	123271348	Anapc5	-	33870	10403
chr5	123831275	123832741	1466	chr5	123793843	123824091	Bcl7a	+	30248	7184
chr5	124347061	124348061	1000	chr5	124357184	124378841	Denr	+	21657	9123
chr5	124499964	124502859	2895	chr5	124511539	124545807	Abcb9	-	34268	8680
chr5	125402734	125403835	1101	chr5	125343061	125383063	Zfp664	+	40002	19671
chr5	125409395	125410395	1000	chr5	125343061	125383063	Zfp664	+	40002	26332
chr5	125423937	125424939	1002	chr5	125343061	125383063	Zfp664	+	40002	40874
chr5	125440725	125441739	1014	chr5	125483817	125492917	Fam101a	+	9100	42078
chr5	125837961	125839403	1442	chr5	125757457	125821464	Scarb1	-	64007	16497
chr5	125840893	125841965	1072	chr5	125757457	125821464	Scarb1	-	64007	19429
chr5	125848489	125849489	1000	chr5	125866335	125870572	Ubc	-	4237	16846
chr5	125855422	125856511	1089	chr5	125866335	125870572	Ubc	-	4237	9824
chr5	125856835	125857873	1038	chr5	125866335	125870572	Ubc	-	4237	8462
chr5	125885122	125887459	2337	chr5	125894230	125914491	Dhx37	-	20261	6771
chr5	129582371	129585486	3115	chr5	129602625	129710474	Gpr133	+	107849	17139
chr5	135046834	135048469	1635	chr5	135058560	135074198	Rfc2	+	15638	10091
chr5	135438730	135440510	1780	chr5	135420996	135422804	Cldn4	-	1808	15926
chr5	135441418	135442418	1000	chr5	135420996	135422804	Cldn4	-	1808	18614
chr5	138147874	138148874	1000	chr5	138161582	138162968	Gm15753	-	1386	12708
chr5	138387975	138388975	1000	chr5	138395037	138404187	Gjc3	-	9150	6062
chr5	139158560	139160954	2394	chr5	139064087	139090052	A430033K04Rik	+	25965	68508
chr5	139161305	139162851	1546	chr5	139230468	139286031	Fam20c	+	55563	67617
chr5	139169886	139170950	1064	chr5	139230468	139286031	Fam20c	+	55563	59518
chr5	141072134	141073850	1716	chr5	141083295	141091497	Lfng	+	8202	9445
chr5	141489532	141491150	1618	chr5	141348953	141476550	Card11	-	127597	12982
chr5	141493204	141495109	1905	chr5	141348953	141476550	Card11	-	127597	16654
chr5	141530959	141533099	2140	chr5	141556385	141556463	AC161570.1	+	78	23286
chr5	142843054	142844668	1614	chr5	142877451	142937968	Foxk1	+	60517	32783
chr5	142849917	142852436	2519	chr5	142877451	142937968	Foxk1	+	60517	25015
chr5	143690604	143691705	1101	chr5	143664794	143668433	Actb	-	3639	22171
chr5	143693390	143694493	1103	chr5	143664794	143668433	Actb	-	3639	24957
chr5	144040339	144041370	1031	chr5	144011376	144031701	Zfp316	-	20325	8638
chr5	145443728	145446925	3197	chr5	145484496	145484666	Gm6272	-	170	37571
chr5	147407711	147410461	2750	chr5	147393727	147396815	Gpr12	-	3088	10896
chr5	147466063	147467895	1832	chr5	147393727	147396815	Gpr12	-	3088	69248
chr5	147486754	147489098	2344	chr5	147546385	147606582	Usp12	-	60197	57287
chr5	147492423	147494126	1703	chr5	147546385	147606582	Usp12	-	60197	52259
chr5	147498882	147499882	1000	chr5	147546385	147606582	Usp12	-	60197	46503
chr5	147617058	147618778	1720	chr5	147546385	147606582	Usp12	-	60197	10476
chr5	147672614	147674322	1708	chr5	147656647	147659302	Rasl11a	+	2655	13312
chr5	147678385	147679999	1614	chr5	147656647	147659302	Rasl11a	+	2655	19083
chr5	149300238	149302063	1825	chr5	149316207	149364365	Ubl3	-	48158	14144
chr5	149303977	149305565	1588	chr5	149316207	149364365	Ubl3	-	48158	10642
chr5	149305699	149307705	2006	chr5	149316207	149364365	Ubl3	-	48158	8502
chr5	149435735	149436762	1027	chr5	149316207	149364365	Ubl3	-	48158	71370
chr5	149444963	149445963	1000	chr5	149316207	149364365	Ubl3	-	48158	80598
chr5	149456444	149457444	1000	chr5	149316207	149364365	Ubl3	-	48158	92079
chr5	149463590	149465382	1792	chr5	149553416	149554715	2210417A02Rik	+	1299	88034
chr5	149490023	149491450	1427	chr5	149553416	149554715	2210417A02Rik	+	1299	61966
chr5	149678396	149680168	1772	chr5	149685908	149806799	Katnal1	-	120891	5740
chr5	149842465	149843682	1217	chr5	149858278	149865089	Hmgb1	-	6811	14596
chr5	149879059	149880845	1786	chr5	149858278	149865089	Hmgb1	-	6811	13970
chr5	149899331	149901733	2402	chr5	149931141	149995639	5730422E09Rik	-	64498	29408
chr5	149909655	149911377	1722	chr5	149931141	149995639	5730422E09Rik	-	64498	19764
chr5	150654299	150656141	1842	chr5	150480805	150565174	B3galtl	+	84369	89125
chr5	151402643	151404407	1764	chr5	151374218	151397100	N4bp2l1	-	22882	5543
chr5	9087100	9088157	1057	chr5	9100737	9118983	4930420K17Rik	+	18246	12580
chr5	15975716	15976716	1000	chr5	16059368	16125257	Hgf	+	65889	82652
chr5	23225065	23226065	1000	chr5	23216809	23216879	SNORD93	-	70	8186
chr5	30320049	30321212	1163	chr5	30339701	30346508	Il6	+	6807	18489
chr5	33015648	33016721	1073	chr5	32913606	32989430	Yes1	+	75824	26218
chr5	33381448	33382448	1000	chr5	33361465	33370615	Ywhah	+	9150	10833
chr5	34678716	34679841	1125	chr5	34688360	34696083	Rnf4	+	7723	8519
chr5	39729340	39730720	1380	chr5	39737930	39738223	7SK	+	293	7210
chr5	44247216	44248216	1000	chr5	44260048	44303614	Cd38	+	43566	11832
chr5	53793906	53794906	1000	chr5	53809812	53809921	5S_rRNA	+	109	14906
chr5	53934619	53936947	2328	chr5	53947018	54048684	Rbpj	+	101666	10071
chr5	53937600	53938655	1055	chr5	53947018	54048684	Rbpj	+	101666	8363
chr5	63182348	63184222	1874	chr5	63205062	63279547	Gm17384	+	74485	20840
chr5	63300284	63301284	1000	chr5	63205062	63279547	Gm17384	+	74485	20737
chr5	64421273	64422381	1108	chr5	64393592	64393723	SNORA17	-	131	27550
chr5	64990741	64991774	1033	chr5	65038872	65038988	AC122043.1	-	116	47098
chr5	66309977	66311371	1394	chr5	66326160	66368565	Chrna9	+	42405	14789
chr5	74522395	74523395	1000	chr5	74489085	74491430	2700023E23Rik	+	2345	30965
chr5	76447780	76448878	1098	chr5	76402344	76402466	5S_rRNA	-	122	45314
chr5	77559608	77560608	1000	chr5	77545835	77551373	Gm15831	-	5538	8235
chr5	77682607	77683607	1000	chr5	77694516	77715457	Rest	+	20941	10909
chr5	91024077	91025077	1000	chr5	91032102	91069513	Rassf6	-	37411	7025
chr5	97347225	97348672	1447	chr5	97336651	97336844	U2	+	193	10381
chr5	101036813	101037813	1000	chr5	100982744	101001264	Plac8	-	18520	35549
chr5	101667949	101669121	1172	chr5	101274732	101328121	Agpat9	+	53389	339828
chr5	105000334	105001489	1155	chr5	104954754	104983230	D930016D06Rik	+	28476	17104
chr5	106077794	106078794	1000	chr5	105948407	106042037	Lrrc8c	+	93630	35757
chr5	106080061	106081068	1007	chr5	105948407	106042037	Lrrc8c	+	93630	38024
chr5	107440788	107441788	1000	chr5	107393341	107413451	Cdc7	+	20110	27337
chr5	113464163	113465495	1332	chr5	113473164	113473272	U6	+	108	7669
chr5	118781509	118782541	1032	chr5	118716458	118716589	SNORA17	+	131	64920
chr5	118810039	118811056	1017	chr5	118868736	118868827	AC132338.1	-	91	57680
chr5	118811556	118812556	1000	chr5	118868736	118868827	AC132338.1	-	91	56180
chr5	141519806	141520806	1000	chr5	141556385	141556463	AC161570.1	+	78	35579
chr5	142867954	142869232	1278	chr5	142877451	142937968	Foxk1	+	60517	8219
chr5	143682391	143683412	1021	chr5	143664794	143668433	Actb	-	3639	13958
chr5	147635569	147637152	1583	chr5	147644466	147648608	Rpl21	+	4142	7314
chr5	149376205	149377205	1000	chr5	149316207	149364365	Ubl3	-	48158	11840
chr5	149406371	149408415	2044	chr5	149316207	149364365	Ubl3	-	48158	42006
chr5	149459227	149460278	1051	chr5	149553416	149554715	2210417A02Rik	+	1299	93138
chr5	149519727	149520727	1000	chr5	149553416	149554715	2210417A02Rik	+	1299	32689
chr5	150040501	150041544	1043	chr5	149995926	150027010	Uspl1	+	31084	13491
chr6	4539289	4542153	2864	chr6	4550840	4593381	Casd1	+	42541	8687
chr6	5264555	5265708	1153	chr6	5214147	5248455	Pon2	-	34308	16100
chr6	5532355	5534123	1768	chr6	5433351	5446309	Pdk4	-	12958	86046
chr6	12074489	12076236	1747	chr6	12049518	12059583	Gm6578	-	10065	14906
chr6	13643215	13647418	4203	chr6	13575677	13627966	B630005N14Rik	-	52289	15249
chr6	14070564	14071740	1176	chr6	14063316	14063431	SNORA17	+	115	7133
chr6	15575405	15577119	1714	chr6	15670661	15752169	Mdfic	+	81508	93542
chr6	15593394	15595770	2376	chr6	15670661	15752169	Mdfic	+	81508	74891
chr6	15620558	15622428	1870	chr6	15670661	15752169	Mdfic	+	81508	48233
chr6	15632888	15633888	1000	chr6	15670661	15752169	Mdfic	+	81508	36773
chr6	15659135	15662220	3085	chr6	15670661	15752169	Mdfic	+	81508	8441
chr6	15790928	15792904	1976	chr6	15670661	15752169	Mdfic	+	81508	38759
chr6	15794372	15797469	3097	chr6	15670661	15752169	Mdfic	+	81508	42203
chr6	15875989	15877769	1780	chr6	15670661	15752169	Mdfic	+	81508	123820
chr6	17578470	17580800	2330	chr6	17586234	17616972	Capza2	+	30738	5434
chr6	17624406	17625406	1000	chr6	17586234	17616972	Capza2	+	30738	7434
chr6	17625588	17628208	2620	chr6	17586234	17616972	Capza2	+	30738	8616
chr6	22340187	22342812	2625	chr6	22256520	22306243	Fam3c	-	49723	33944
chr6	22356168	22358561	2393	chr6	22256520	22306243	Fam3c	-	49723	49925
chr6	22358658	22359774	1116	chr6	22256520	22306243	Fam3c	-	49723	52415
chr6	22360151	22362976	2825	chr6	22256520	22306243	Fam3c	-	49723	53908
chr6	22372923	22374826	1903	chr6	22256520	22306243	Fam3c	-	49723	66680
chr6	22409197	22410197	1000	chr6	22256520	22306243	Fam3c	-	49723	102954
chr6	22424087	22425087	1000	chr6	22256520	22306243	Fam3c	-	49723	117844
chr6	24011444	24013214	1770	chr6	24038283	24118092	Slc13a1	-	79809	25069
chr6	24260211	24262099	1888	chr6	24394865	24465067	Iqub	-	70202	132766
chr6	26715439	26717290	1851	chr6	26410291	26410430	U1	-	139	305009
chr6	29195135	29197594	2459	chr6	29184434	29184564	SNORA17	+	130	10571
chr6	29213696	29214696	1000	chr6	29222488	29225446	Hilpda	+	2958	7792
chr6	30987788	30988788	1000	chr6	31012660	31012747	Mir29a	-	87	23872
chr6	31025087	31028175	3088	chr6	31037609	31037912	Gm13834	-	303	9434
chr6	31029305	31031798	2493	chr6	31037609	31037912	Gm13834	-	303	5811
chr6	31060597	31067027	6430	chr6	31052846	31054646	Gm13833	+	1800	5951
chr6	31070004	31072848	2844	chr6	31052846	31054646	Gm13833	+	1800	15358
chr6	34177279	34178279	1000	chr6	34129232	34136392	Gm13855	+	7160	40887
chr6	34944560	34945754	1194	chr6	34895278	34929054	2010107G12Rik	-	33776	15506
chr6	37413247	37415347	2100	chr6	37277255	37392146	Creb3l2	-	114891	21101
chr6	37566853	37568486	1633	chr6	37530335	37530427	AC157101.1	+	92	36426
chr6	37654075	37656692	2617	chr6	37756086	37756553	Gm15487	+	467	99394
chr6	37659849	37661443	1594	chr6	37756086	37756553	Gm15487	+	467	94643
chr6	37681809	37683399	1590	chr6	37756086	37756553	Gm15487	+	467	72687
chr6	37792673	37794774	2101	chr6	37820811	37916296	Trim24	+	95485	26037
chr6	38309705	38310877	1172	chr6	38255286	38304603	Zc3hav1	-	49317	5102
chr6	38568173	38570532	2359	chr6	38576660	38587239	Klrg2	-	10579	6128
chr6	39176116	39177425	1309	chr6	39086622	39156788	Jhdm1d	-	70166	19328
chr6	39180071	39181628	1557	chr6	39086622	39156788	Jhdm1d	-	70166	23283
chr6	39190309	39193685	3376	chr6	39215843	39215941	U6	-	98	22158
chr6	39206354	39209549	3195	chr6	39215843	39215941	U6	-	98	6294
chr6	40767876	40768876	1000	chr6	40578830	40719122	Mgam	+	140292	48754
chr6	47570398	47572330	1932	chr6	47587142	47587218	Y_RNA	+	76	14812
chr6	47573830	47577300	3470	chr6	47587142	47587218	Y_RNA	+	76	9842
chr6	48751395	48752395	1000	chr6	48783810	48791373	Tmem176b	-	7563	31415
chr6	48767894	48768894	1000	chr6	48783810	48791373	Tmem176b	-	7563	14916
chr6	49227200	49228200	1000	chr6	49193920	49214051	Tra2a	-	20131	13149
chr6	49535644	49537554	1910	chr6	49345603	49419500	Stk31	+	73897	116144
chr6	50765227	50768544	3317	chr6	50796523	50828078	G930045G22Rik	-	31555	27979
chr6	50772817	50774349	1532	chr6	50796523	50828078	G930045G22Rik	-	31555	22174
chr6	50928989	50930608	1619	chr6	50796523	50828078	G930045G22Rik	-	31555	100911
chr6	50955752	50956752	1000	chr6	50796523	50828078	G930045G22Rik	-	31555	127674
chr6	51079121	51080177	1056	chr6	51219811	51219909	Mir148a	-	98	139634
chr6	51099767	51101809	2042	chr6	51219811	51219909	Mir148a	-	98	118002
chr6	51236611	51239051	2440	chr6	51219811	51219909	Mir148a	-	98	16702
chr6	51279257	51281666	2409	chr6	51329709	51342776	Gm17725	-	13067	48043
chr6	51294441	51296097	1656	chr6	51329709	51342776	Gm17725	-	13067	33612
chr6	52647831	52648851	1020	chr6	52663723	52716774	Tax1bp1	+	53051	14872
chr6	53166571	53167817	1246	chr6	53237289	53397716	9430076C15Rik	+	160427	69472
chr6	53403853	53407146	3293	chr6	53237289	53397716	9430076C15Rik	+	160427	6137
chr6	53412698	53414523	1825	chr6	53237289	53397716	9430076C15Rik	+	160427	14982
chr6	53417915	53419523	1608	chr6	53237289	53397716	9430076C15Rik	+	160427	20199
chr6	53447144	53448895	1751	chr6	53237289	53397716	9430076C15Rik	+	160427	49428
chr6	54665265	54666265	1000	chr6	54631734	54653845	2410066E13Rik	+	22111	11420
chr6	54668367	54669367	1000	chr6	54631734	54653845	2410066E13Rik	+	22111	14522
chr6	54685618	54686618	1000	chr6	54631734	54653845	2410066E13Rik	+	22111	31773
chr6	54701830	54703148	1318	chr6	54631734	54653845	2410066E13Rik	+	22111	47985
chr6	54709307	54710781	1474	chr6	54631734	54653845	2410066E13Rik	+	22111	55462
chr6	54730224	54731963	1739	chr6	54766910	54843494	Znrf2	+	76584	34947
chr6	54743135	54745536	2401	chr6	54766910	54843494	Znrf2	+	76584	21374
chr6	57491387	57492832	1445	chr6	57456496	57485420	Ppm1k	-	28924	5967
chr6	59134832	59136232	1400	chr6	59158864	59162027	Tigd2	+	3163	22632
chr6	59199860	59201732	1872	chr6	59158864	59162027	Tigd2	+	3163	37833
chr6	59250216	59252001	1785	chr6	59302455	59376284	Gprin3	-	73829	50454
chr6	59265310	59266310	1000	chr6	59302455	59376284	Gprin3	-	73829	36145
chr6	59400398	59402342	1944	chr6	59302455	59376284	Gprin3	-	73829	24114
chr6	61015078	61018971	3893	chr6	60874970	60939372	Mmrn1	+	64402	75706
chr6	65459419	65461215	1796	chr6	65331099	65408144	C130060K24Rik	+	77045	51275
chr6	65474916	65475983	1067	chr6	65540392	65584034	Tnip3	+	43642	64409
chr6	65477757	65478757	1000	chr6	65540392	65584034	Tnip3	+	43642	61635
chr6	65513148	65514959	1811	chr6	65540392	65584034	Tnip3	+	43642	25433
chr6	67364653	67366241	1588	chr6	67372926	67441849	Il23r	-	68923	6685
chr6	69630933	69631933	1000	chr6	69650761	69651281	Igkv4-50	-	520	18828
chr6	69990219	69991851	1632	chr6	69977976	69978085	AC154006.1	-	109	12134
chr6	70052609	70054551	1942	chr6	70067055	70067611	Igkv8-30	-	556	12504
chr6	70684579	70686537	1958	chr6	70676429	70676751	Igkc	+	322	7828
chr6	70693216	70695131	1915	chr6	70676429	70676751	Igkc	+	322	16465
chr6	70701041	70702683	1642	chr6	70715714	70742226	Rpia	-	26512	13031
chr6	70763236	70765044	1808	chr6	70715714	70742226	Rpia	-	26512	21010
chr6	70773843	70776292	2449	chr6	70794509	70855239	Eif2ak3	+	60730	18217
chr6	72114235	72115235	1000	chr6	72047607	72104564	St3gal5	+	56957	9671
chr6	72436007	72437185	1178	chr6	72463638	72471628	Sh2d6	-	7990	26453
chr6	72887294	72888368	1074	chr6	72903230	72907243	Gm17554	+	4013	14862
chr6	73264313	73265313	1000	chr6	73198376	73226905	Suclg1	+	28529	37408
chr6	82664381	82666578	2197	chr6	82675019	82724448	Hk2	-	49429	8441
chr6	83405307	83406579	1272	chr6	83391749	83398316	B230319C09Rik	+	6567	6991
chr6	83421131	83422131	1000	chr6	83430211	83456963	Dguok	-	26752	8080
chr6	83531545	83533236	1691	chr6	83541815	83542137	7SK	-	322	8579
chr6	83816668	83818417	1749	chr6	83824193	83825421	Gm5138	-	1228	5776
chr6	83836063	83837063	1000	chr6	83824193	83825421	Gm5138	-	1228	10642
chr6	86436549	86438351	1802	chr6	86420799	86430824	A430078I02Rik	-	10025	5725
chr6	86443615	86444615	1000	chr6	86420799	86430824	A430078I02Rik	-	10025	12791
chr6	86534251	86536294	2043	chr6	86524094	86524155	AC158662.1	-	61	10096
chr6	86772127	86773229	1102	chr6	86799511	86941858	Aak1	+	142347	26282
chr6	87068718	87070758	2040	chr6	87054820	87062245	D6Ertd527e	+	7425	6473
chr6	87076459	87078004	1545	chr6	87083848	87285769	Antxr1	-	201921	5844
chr6	87349200	87351349	2149	chr6	87333262	87338929	Gkn3	-	5667	10271
chr6	87396071	87399585	3514	chr6	87408539	87483253	Arhgap25	-	74714	8954
chr6	87490182	87493399	3217	chr6	87408539	87483253	Arhgap25	-	74714	6929
chr6	87496860	87498423	1563	chr6	87408539	87483253	Arhgap25	-	74714	13607
chr6	87500664	87504006	3342	chr6	87408539	87483253	Arhgap25	-	74714	17411
chr6	87663264	87664467	1203	chr6	87677235	87677327	AC158626.1	+	92	12768
chr6	88010109	88011634	1525	chr6	87949100	87995264	Rab7	-	46164	14845
chr6	88013942	88015706	1764	chr6	87949100	87995264	Rab7	-	46164	18678
chr6	88024442	88025506	1064	chr6	88034467	88055298	Rpn1	+	20831	8961
chr6	88063942	88064942	1000	chr6	88034467	88055298	Rpn1	+	20831	8644
chr6	88065350	88067057	1707	chr6	88034467	88055298	Rpn1	+	20831	10052
chr6	88888390	88890749	2359	chr6	88852245	88862232	Tpra1	+	9987	26158
chr6	88906780	88908189	1409	chr6	88852245	88862232	Tpra1	+	9987	44548
chr6	88913369	88915524	2155	chr6	88852245	88862232	Tpra1	+	9987	51137
chr6	88992290	88993290	1000	chr6	89046104	89060031	4933427D06Rik	+	13927	52814
chr6	89205544	89206544	1000	chr6	89199462	89199596	5S_rRNA	-	134	5948
chr6	89206875	89207932	1057	chr6	89199462	89199596	5S_rRNA	-	134	7279
chr6	89235369	89239306	3937	chr6	89254624	89277615	Gm16896	+	22991	15318
chr6	91072934	91073934	1000	chr6	90963062	91066823	Nup210	-	103761	6111
chr6	98055283	98056283	1000	chr6	97757052	97971352	Mitf	+	214300	83931
chr6	98795426	98797701	2275	chr6	98875332	99472715	Foxp1	-	597383	77631
chr6	99734018	99735018	1000	chr6	99675765	99682547	Gm16748	+	6782	51471
chr6	99760563	99761563	1000	chr6	99827741	99828427	Tpt1-ps3	-	686	66178
chr6	100033127	100034389	1262	chr6	100178560	100237435	Rybp	-	58875	144171
chr6	100035402	100037178	1776	chr6	100178560	100237435	Rybp	-	58875	141382
chr6	100291139	100292954	1815	chr6	100178560	100237435	Rybp	-	58875	53704
chr6	100306362	100307420	1058	chr6	100178560	100237435	Rybp	-	58875	68927
chr6	100312826	100314722	1896	chr6	100178560	100237435	Rybp	-	58875	75391
chr6	100319702	100321815	2113	chr6	100178560	100237435	Rybp	-	58875	82267
chr6	100359528	100360580	1052	chr6	100444675	100444808	SNORA17	-	133	84095
chr6	100387844	100389667	1823	chr6	100444675	100444808	SNORA17	-	133	55008
chr6	100419375	100421161	1786	chr6	100444675	100444808	SNORA17	-	133	23514
chr6	100426533	100429638	3105	chr6	100444675	100444808	SNORA17	-	133	15037
chr6	100432507	100433507	1000	chr6	100444675	100444808	SNORA17	-	133	11168
chr6	100470597	100472679	2082	chr6	100444675	100444808	SNORA17	-	133	25789
chr6	100761125	100762292	1167	chr6	100654728	100755075	Gxylt2	+	100347	6050
chr6	100774164	100776055	1891	chr6	100783632	100818711	Ppp4r2	+	35079	7577
chr6	103288749	103289769	1020	chr6	103460870	103699671	Chl1	+	238801	171101
chr6	106710093	106712951	2858	chr6	106719114	106732468	Trnt1	+	13354	6163
chr6	108048356	108049356	1000	chr6	108057022	108135576	Sumf1	-	78554	7666
chr6	108142007	108143156	1149	chr6	108057022	108135576	Sumf1	-	78554	6431
chr6	108146522	108147699	1177	chr6	108057022	108135576	Sumf1	-	78554	10946
chr6	108637669	108639576	1907	chr6	108610623	108616919	Bhlhe40	+	6296	20750
chr6	108645267	108646682	1415	chr6	108610623	108616919	Bhlhe40	+	6296	28348
chr6	108651847	108658291	6444	chr6	108610623	108616919	Bhlhe40	+	6296	34928
chr6	108658862	108660880	2018	chr6	108610623	108616919	Bhlhe40	+	6296	41943
chr6	108666827	108669852	3025	chr6	108610623	108616919	Bhlhe40	+	6296	49908
chr6	108705604	108706604	1000	chr6	108733053	108773717	Arl8b	+	40664	26449
chr6	113174719	113177324	2605	chr6	113187837	113231386	Mtmr14	+	43549	10513
chr6	114938156	114939577	1421	chr6	114953065	114953150	U3	+	85	13488
chr6	114940865	114943076	2211	chr6	114953065	114953150	U3	+	85	9989
chr6	115643257	115644979	1722	chr6	115626161	115626657	D830050J10Rik	+	496	16600
chr6	115647064	115648302	1238	chr6	115626161	115626657	D830050J10Rik	+	496	20407
chr6	117828889	117831163	2274	chr6	117812118	117822784	Zfp239	+	10666	6105
chr6	117839765	117842348	2583	chr6	117850358	117875639	Hnrnpf	+	25281	8010
chr6	120488889	120489889	1000	chr6	120459512	120481337	Cecr5	-	21825	7552
chr6	120516939	120519176	2237	chr6	120459512	120481337	Cecr5	-	21825	35602
chr6	120521603	120523429	1826	chr6	120459512	120481337	Cecr5	-	21825	40266
chr6	120529024	120531163	2139	chr6	120459512	120481337	Cecr5	-	21825	47687
chr6	120534931	120535981	1050	chr6	120459512	120481337	Cecr5	-	21825	53594
chr6	120541803	120543047	1244	chr6	120459512	120481337	Cecr5	-	21825	60466
chr6	120568608	120569633	1025	chr6	120616387	120721208	Cecr2	+	104821	46754
chr6	120585482	120586673	1191	chr6	120616387	120721208	Cecr2	+	104821	29714
chr6	120593271	120595434	2163	chr6	120616387	120721208	Cecr2	+	104821	20953
chr6	121079535	121080535	1000	chr6	120951381	121031627	Mical3	-	80246	47908
chr6	122242007	122248248	6241	chr6	122220614	122232900	Klrg1	-	12286	9107
chr6	122493973	122496501	2528	chr6	122503819	122514198	Aicda	+	10379	7318
chr6	122603567	122605499	1932	chr6	122576428	122580290	Dppa3	+	3862	23277
chr6	125039245	125040262	1017	chr6	125045999	125080609	Chd4	+	34610	5737
chr6	125214578	125216170	1592	chr6	125208067	125208195	SNORA70	-	128	6383
chr6	125220992	125222636	1644	chr6	125228292	125236060	Tuba3a	-	7768	5656
chr6	125375634	125377299	1665	chr6	125410284	125444809	Cd9	-	34525	32985
chr6	125383434	125384434	1000	chr6	125410284	125444809	Cd9	-	34525	25850
chr6	125394958	125395958	1000	chr6	125410284	125444809	Cd9	-	34525	14326
chr6	125490204	125491204	1000	chr6	125496792	125636697	Vwf	+	139905	5588
chr6	126387245	126388684	1439	chr6	126482571	126485573	Kcna5	-	3002	93887
chr6	126945920	126946920	1000	chr6	126965560	126974736	Fgf6	+	9176	18640
chr6	127168675	127169942	1267	chr6	127099407	127162429	9330179D12Rik	+	63022	6246
chr6	127195765	127198974	3209	chr6	127183774	127184637	Gm4968	+	863	11128
chr6	127201787	127205834	4047	chr6	127183774	127184637	Gm4968	+	863	17150
chr6	127213792	127217814	4022	chr6	127232081	127232527	Gm7308	-	446	14267
chr6	127220395	127221883	1488	chr6	127232081	127232527	Gm7308	-	446	10198
chr6	127222123	127223123	1000	chr6	127232081	127232527	Gm7308	-	446	8958
chr6	127279493	127281205	1712	chr6	127232081	127232527	Gm7308	-	446	46966
chr6	127300817	127302556	1739	chr6	127232081	127232527	Gm7308	-	446	68290
chr6	127308627	127309632	1005	chr6	127232081	127232527	Gm7308	-	446	76100
chr6	127511004	127512004	1000	chr6	127527993	127579956	Efcab4b	+	51963	15989
chr6	128681817	128684573	2756	chr6	128656526	128673064	Klrb1	-	16538	8753
chr6	128709891	128710911	1020	chr6	128728503	128739233	Klrb1c	-	10730	17592
chr6	128715098	128716176	1078	chr6	128728503	128739233	Klrb1c	-	10730	12327
chr6	128720341	128723080	2739	chr6	128728503	128739233	Klrb1c	-	10730	5423
chr6	128747972	128750226	2254	chr6	128728503	128739233	Klrb1c	-	10730	8739
chr6	129016018	129017018	1000	chr6	128995919	129007489	Klrb1f	+	11570	8529
chr6	129141765	129145036	3271	chr6	129130633	129136552	Clec2d	+	5919	5213
chr6	129265916	129266994	1078	chr6	129272183	129281814	4922502D21Rik	-	9631	5189
chr6	131354230	131356287	2057	chr6	131314876	131338468	Csda	-	23592	15762
chr6	131383180	131384324	1144	chr6	131314876	131338468	Csda	-	23592	44712
chr6	133934727	133935994	1267	chr6	133985718	134220176	Etv6	+	234458	49724
chr6	133970235	133972679	2444	chr6	133985718	134220176	Etv6	+	234458	13039
chr6	134282532	134283796	1264	chr6	133985718	134220176	Etv6	+	234458	62356
chr6	134298163	134300029	1866	chr6	134346336	134388754	Bcl2l14	+	42418	46307
chr6	134895430	134896430	1000	chr6	134870419	134875531	Cdkn1b	+	5112	19899
chr6	135272794	135275220	2426	chr6	135259802	135260365	Pbp2	-	563	12429
chr6	136397613	136399787	2174	chr6	136366333	136366417	U4	+	84	31196
chr6	136415916	136417154	1238	chr6	136434643	136438660	Gm6728	-	4017	17489
chr6	136417705	136420377	2672	chr6	136434643	136438660	Gm6728	-	4017	14266
chr6	136631397	136634490	3093	chr6	136645806	136730286	Gucy2c	-	84480	11316
chr6	136637708	136638994	1286	chr6	136645806	136730286	Gucy2c	-	84480	6812
chr6	140559762	140564577	4815	chr6	140570970	140626993	Aebp2	+	56023	6393
chr6	140655969	140656969	1000	chr6	140677805	140704574	Gm11077	+	26769	20836
chr6	140763812	140766486	2674	chr6	140677805	140704574	Gm11077	+	26769	59238
chr6	143057986	143058986	1000	chr6	142959440	143048627	5730419I09Rik	-	89187	9359
chr6	143062997	143064192	1195	chr6	142959440	143048627	5730419I09Rik	-	89187	14370
chr6	143099673	143100910	1237	chr6	143090111	143090384	AC127354.1	-	273	9289
chr6	143699333	143700655	1322	chr6	143776945	144730497	Sox5	-	953552	76290
chr6	144850443	144852089	1646	chr6	144942355	145024704	Bcat1	-	82349	90266
chr6	144858004	144860801	2797	chr6	144942355	145024704	Bcat1	-	82349	81554
chr6	144871165	144872165	1000	chr6	144942355	145024704	Bcat1	-	82349	70190
chr6	145036953	145039959	3006	chr6	144942355	145024704	Bcat1	-	82349	12249
chr6	145048890	145050443	1553	chr6	145064173	145123454	Lrmp	+	59281	13730
chr6	145052330	145053330	1000	chr6	145064173	145123454	Lrmp	+	59281	10843
chr6	145224197	145225267	1070	chr6	145214906	145215345	Rps25-ps1	+	439	8852
chr6	145288476	145289552	1076	chr6	145264133	145265128	Gm15707	-	995	23348
chr6	145792990	145797064	4074	chr6	145806763	145814078	Bhlhe41	-	7315	9699
chr6	145830675	145833171	2496	chr6	145806763	145814078	Bhlhe41	-	7315	16597
chr6	145835649	145837715	2066	chr6	145806763	145814078	Bhlhe41	-	7315	21571
chr6	145840080	145843611	3531	chr6	145806763	145814078	Bhlhe41	-	7315	26002
chr6	145854347	145855347	1000	chr6	145880161	145913743	Sspn	+	33582	24814
chr6	145928825	145931111	2286	chr6	145880161	145913743	Sspn	+	33582	15082
chr6	145940881	145942884	2003	chr6	145880161	145913743	Sspn	+	33582	27138
chr6	145948642	145951573	2931	chr6	145880161	145913743	Sspn	+	33582	34899
chr6	146028524	146029583	1059	chr6	146056821	146450745	Itpr2	-	393924	27238
chr6	146458928	146462048	3120	chr6	146056821	146450745	Itpr2	-	393924	8183
chr6	146462281	146463469	1188	chr6	146056821	146450745	Itpr2	-	393924	11536
chr6	146468232	146471080	2848	chr6	146056821	146450745	Itpr2	-	393924	17487
chr6	146478148	146480821	2673	chr6	146498154	146526357	4933424B01Rik	-	28203	17333
chr6	146485851	146487765	1914	chr6	146498154	146526357	4933424B01Rik	-	28203	10389
chr6	146621887	146624644	2757	chr6	146605740	146613925	4930479D17Rik	+	8185	7962
chr6	149067837	149068837	1000	chr6	149078692	149079232	Gm10203	+	540	9855
chr6	149291483	149294133	2650	chr6	149257936	149284180	2810474O19Rik	+	26244	7303
chr6	149322789	149324218	1429	chr6	149310208	149311669	Gm15784	+	1461	11120
chr6	3293742	3295110	1368	chr6	3322257	3349571	Samd9l	-	27314	27147
chr6	3295212	3296353	1141	chr6	3322257	3349571	Samd9l	-	27314	25904
chr6	13011006	13012602	1596	chr6	13019759	13039269	Tmem106b	+	19510	7157
chr6	13641720	13643066	1346	chr6	13575677	13627966	B630005N14Rik	-	52289	13754
chr6	17561535	17562815	1280	chr6	17586234	17616972	Capza2	+	30738	23419
chr6	22328475	22329613	1138	chr6	22256520	22306243	Fam3c	-	49723	22232
chr6	22335350	22336350	1000	chr6	22256520	22306243	Fam3c	-	49723	29107
chr6	24188134	24189134	1000	chr6	24038283	24118092	Slc13a1	-	79809	70042
chr6	31075532	31076647	1115	chr6	31091979	31092663	Gm13835	-	684	15332
chr6	37771424	37772477	1053	chr6	37756086	37756553	Gm15487	+	467	14871
chr6	39768897	39769897	1000	chr6	39751803	39760987	Mrps33	-	9184	7910
chr6	47600667	47601914	1247	chr6	47587142	47587218	Y_RNA	+	76	13449
chr6	52427487	52428487	1000	chr6	52496222	52590383	Hibadh	-	94161	67735
chr6	54687445	54688711	1266	chr6	54631734	54653845	2410066E13Rik	+	22111	33600
chr6	54759617	54761189	1572	chr6	54766910	54843494	Znrf2	+	76584	5721
chr6	59263494	59264649	1155	chr6	59302455	59376284	Gprin3	-	73829	37806
chr6	65515138	65516138	1000	chr6	65540392	65584034	Tnip3	+	43642	24254
chr6	70699925	70700925	1000	chr6	70715714	70742226	Rpia	-	26512	14789
chr6	70702712	70704517	1805	chr6	70715714	70742226	Rpia	-	26512	11197
chr6	70754849	70755849	1000	chr6	70715714	70742226	Rpia	-	26512	12623
chr6	70780632	70781690	1058	chr6	70794509	70855239	Eif2ak3	+	60730	12819
chr6	71116807	71117836	1029	chr6	71078160	71094340	Thnsl2	-	16180	22467
chr6	86447320	86448320	1000	chr6	86420799	86430824	A430078I02Rik	-	10025	16496
chr6	88949697	88950791	1094	chr6	88852245	88862232	Tpra1	+	9987	87465
chr6	89208082	89209195	1113	chr6	89199462	89199596	5S_rRNA	-	134	8486
chr6	89246327	89247385	1058	chr6	89254624	89277615	Gm16896	+	22991	7239
chr6	97228055	97229055	1000	chr6	97236861	97567535	Frmd4b	-	330674	7806
chr6	98016387	98017387	1000	chr6	97757052	97971352	Mitf	+	214300	45035
chr6	99816158	99817331	1173	chr6	99827741	99828427	Tpt1-ps3	-	686	10410
chr6	100156800	100157800	1000	chr6	100178560	100237435	Rybp	-	58875	20760
chr6	100360596	100361641	1045	chr6	100444675	100444808	SNORA17	-	133	83034
chr6	100429727	100432248	2521	chr6	100444675	100444808	SNORA17	-	133	12427
chr6	103289792	103290977	1185	chr6	103460870	103699671	Chl1	+	238801	169893
chr6	108661025	108662422	1397	chr6	108610623	108616919	Bhlhe40	+	6296	44106
chr6	115265986	115267048	1062	chr6	115084920	115232644	Syn2	+	147724	33342
chr6	115667664	115668664	1000	chr6	115673713	115673850	SNORA17	-	137	5049
chr6	115953488	115954540	1052	chr6	115904829	115945023	Plxnd1	-	40194	8465
chr6	116674557	116675557	1000	chr6	116642648	116666931	Tmem72	-	24283	7626
chr6	120033026	120034552	1526	chr6	120043368	120150357	Ninj2	+	106989	8816
chr6	121059789	121060847	1058	chr6	120951381	121031627	Mical3	-	80246	28162
chr6	128704117	128705117	1000	chr6	128728503	128739233	Klrb1c	-	10730	23386
chr6	128713954	128715051	1097	chr6	128728503	128739233	Klrb1c	-	10730	13452
chr6	129150161	129151161	1000	chr6	129158430	129188000	2310001H17Rik	-	29570	7269
chr6	129234673	129236832	2159	chr6	129217342	129225387	Cd69	-	8045	9286
chr6	129262475	129263605	1130	chr6	129272183	129281814	4922502D21Rik	-	9631	8578
chr6	133911045	133912045	1000	chr6	133985718	134220176	Etv6	+	234458	73673
chr6	134316351	134317981	1630	chr6	134346336	134388754	Bcl2l14	+	42418	28355
chr6	134752703	134753703	1000	chr6	134665488	134742643	Dusp16	-	77155	10060
chr6	134896519	134897555	1036	chr6	134870419	134875531	Cdkn1b	+	5112	20988
chr6	136412096	136413271	1175	chr6	136434643	136438660	Gm6728	-	4017	21372
chr6	136446242	136448695	2453	chr6	136434643	136438660	Gm6728	-	4017	7582
chr6	136928377	136929447	1070	chr6	136903044	136917386	Pde6h	+	14342	10991
chr6	145289720	145290730	1010	chr6	145313654	145562839	Ifltd1	-	249185	22924
chr6	145783835	145785506	1671	chr6	145695268	145769599	Rassf8	+	74331	14236
chr6	145954306	145955306	1000	chr6	145880161	145913743	Sspn	+	33582	40563
chr7	3275201	3276725	1524	chr7	3289039	3299346	Myadm	+	10307	12314
chr7	16597914	16601115	3201	chr7	16556611	16584844	Gltscr1	-	28233	13070
chr7	16603302	16605697	2395	chr7	16556611	16584844	Gltscr1	-	28233	18458
chr7	16637273	16639221	1948	chr7	16657291	16681677	Zfp541	+	24386	18070
chr7	16640144	16641211	1067	chr7	16657291	16681677	Zfp541	+	24386	16080
chr7	16641886	16642966	1080	chr7	16657291	16681677	Zfp541	+	24386	14325
chr7	16882116	16883116	1000	chr7	16859391	16872144	Ccdc9	-	12753	9972
chr7	16884207	16886081	1874	chr7	16894965	16903554	Bbc3	+	8589	8884
chr7	17316798	17318067	1269	chr7	17307278	17311459	Ceacam9	+	4181	5339
chr7	19904415	19906344	1929	chr7	19888070	19895394	Fosb	-	7324	9021
chr7	19910405	19912282	1877	chr7	19888070	19895394	Fosb	-	7324	15011
chr7	19917577	19919004	1427	chr7	19930127	19941873	Ercc1	+	11746	11123
chr7	20058910	20059910	1000	chr7	20046146	20046284	U1	-	138	12626
chr7	20415548	20417089	1541	chr7	20393811	20408119	Bcl3	-	14308	7429
chr7	25226818	25228932	2114	chr7	25216941	25220553	Irgc1	-	3612	6265
chr7	25229449	25231892	2443	chr7	25216941	25220553	Irgc1	-	3612	8896
chr7	25234972	25235972	1000	chr7	25247519	25260892	Plaur	+	13373	11547
chr7	25236525	25238120	1595	chr7	25247519	25260892	Plaur	+	13373	9399
chr7	25635238	25636413	1175	chr7	25603814	25625294	Gm5893	+	21480	9944
chr7	25738602	25739760	1158	chr7	25754769	25757747	Rabac1	-	2978	15009
chr7	25966369	25967369	1000	chr7	25987859	26004878	Dedd2	-	17019	20490
chr7	26632862	26633862	1000	chr7	26613566	26613914	Gm4613	-	348	18948
chr7	28798438	28799779	1341	chr7	28826726	28835120	Psmc4	-	8394	26947
chr7	28993519	28994519	1000	chr7	28964488	28972313	Dyrk1b	+	7825	21206
chr7	31158466	31159466	1000	chr7	31140533	31147791	Lrfn3	-	7258	10675
chr7	31178635	31179879	1244	chr7	31198807	31202596	Tyrobp	+	3789	18928
chr7	31626442	31629895	3453	chr7	31639349	31641197	Ffar3	-	1848	9454
chr7	31671987	31673072	1085	chr7	31650421	31665361	Cd22	-	14940	6626
chr7	31673546	31677453	3907	chr7	31684202	31699851	Mag	-	15649	6749
chr7	31874105	31875236	1131	chr7	31883744	31900309	Hpn	-	16565	8508
chr7	31945112	31946355	1243	chr7	31934547	31937726	G630030J09Rik	+	3179	7386
chr7	31958786	31960524	1738	chr7	31934547	31937726	G630030J09Rik	+	3179	21060
chr7	31993017	31994161	1144	chr7	31934547	31937726	G630030J09Rik	+	3179	55291
chr7	34683507	34687483	3976	chr7	34664314	34665113	Gm12757	+	799	18394
chr7	35105958	35107834	1876	chr7	35021726	35098570	4931406P16Rik	-	76844	7388
chr7	38845857	38846917	1060	chr7	38883003	38892553	Ccne1	-	9550	36086
chr7	38869094	38871423	2329	chr7	38883003	38892553	Ccne1	-	9550	11580
chr7	38940245	38941780	1535	chr7	38961633	38961690	U7	-	57	19853
chr7	46807141	46808497	1356	chr7	46773136	46795790	Zfp619	+	22654	11351
chr7	46897193	46898566	1373	chr7	46885762	46885872	U6	+	110	11321
chr7	46909832	46911665	1833	chr7	46885762	46885872	U6	+	110	23960
chr7	47019530	47021468	1938	chr7	46885762	46885872	U6	+	110	133658
chr7	47696650	47698157	1507	chr7	47618820	47619091	7SK	+	271	77559
chr7	50597916	50600271	2355	chr7	50606711	50614901	Siglec5	+	8190	6440
chr7	50653002	50655808	2806	chr7	50663574	50673728	Siglecg	+	10154	7766
chr7	50807641	50810088	2447	chr7	50817626	50830831	Zfp658	+	13205	7538
chr7	51815232	51816664	1432	chr7	51804986	51809321	Nr1h2	-	4335	5911
chr7	54276878	54278984	2106	chr7	54245766	54263781	Spty2d1	-	18015	13097
chr7	54285612	54287226	1614	chr7	54306010	54310146	Tmem86a	+	4136	18784
chr7	56004530	56005678	1148	chr7	56044373	56082810	Zdhhc13	+	38437	38695
chr7	56163804	56165081	1277	chr7	56133328	56141978	Gm2788	+	8650	21826
chr7	56166629	56168565	1936	chr7	56133328	56141978	Gm2788	+	8650	24651
chr7	56178426	56180419	1993	chr7	56133328	56141978	Gm2788	+	8650	36448
chr7	57123772	57126623	2851	chr7	57033716	57113635	Prmt3	+	79919	10137
chr7	65653408	65654953	1545	chr7	65664241	65664350	AC102205.1	+	109	9288
chr7	65881544	65882544	1000	chr7	65913572	66084796	Atp10a	+	171224	31028
chr7	66113634	66114634	1000	chr7	66092163	66093308	Gm6226	-	1145	20326
chr7	70961181	70962203	1022	chr7	70589637	70903914	Otud7a	+	314277	57267
chr7	71002983	71004402	1419	chr7	71031237	71083801	Klf13	-	52564	26835
chr7	71094083	71098068	3985	chr7	71106787	71106984	U3	-	197	8719
chr7	71143434	71145102	1668	chr7	71106787	71106984	U3	-	197	36450
chr7	71145177	71147796	2619	chr7	71106787	71106984	U3	-	197	38193
chr7	71148904	71152820	3916	chr7	71106787	71106984	U3	-	197	41920
chr7	71155867	71157699	1832	chr7	71202488	71207844	RP24-292K9.1	+	5356	44789
chr7	71177326	71179049	1723	chr7	71202488	71207844	RP24-292K9.1	+	5356	23439
chr7	71182244	71183350	1106	chr7	71202488	71207844	RP24-292K9.1	+	5356	19138
chr7	71192985	71194473	1488	chr7	71202488	71207844	RP24-292K9.1	+	5356	8015
chr7	73323755	73326407	2652	chr7	73254401	73318675	Chsy1	+	64274	5080
chr7	73329429	73331418	1989	chr7	73254401	73318675	Chsy1	+	64274	10754
chr7	73338214	73340642	2428	chr7	73254401	73318675	Chsy1	+	64274	19539
chr7	73340949	73342751	1802	chr7	73254401	73318675	Chsy1	+	64274	22274
chr7	73344878	73346809	1931	chr7	73371798	73533236	Lrrk1	-	161438	24989
chr7	74546371	74547743	1372	chr7	74376049	74517744	Mef2a	-	141695	28627
chr7	74558914	74560084	1170	chr7	74376049	74517744	Mef2a	-	141695	41170
chr7	74564488	74565691	1203	chr7	74376049	74517744	Mef2a	-	141695	46744
chr7	74569761	74570864	1103	chr7	74376049	74517744	Mef2a	-	141695	52017
chr7	74573394	74574494	1100	chr7	74376049	74517744	Mef2a	-	141695	55650
chr7	74595572	74597397	1825	chr7	74658297	74790122	Lrrc28	-	131825	60900
chr7	74608471	74609987	1516	chr7	74658297	74790122	Lrrc28	-	131825	48310
chr7	74621231	74625071	3840	chr7	74658297	74790122	Lrrc28	-	131825	33226
chr7	74640607	74641607	1000	chr7	74658297	74790122	Lrrc28	-	131825	16690
chr7	74644738	74646809	2071	chr7	74658297	74790122	Lrrc28	-	131825	11488
chr7	74647759	74648817	1058	chr7	74658297	74790122	Lrrc28	-	131825	9480
chr7	74649102	74650820	1718	chr7	74658297	74790122	Lrrc28	-	131825	7477
chr7	80695736	80697234	1498	chr7	80571577	80686632	Chd2	-	115055	9104
chr7	80702049	80703368	1319	chr7	80571577	80686632	Chd2	-	115055	15417
chr7	80727954	80729953	1999	chr7	80571577	80686632	Chd2	-	115055	41322
chr7	80737482	80741575	4093	chr7	80790871	80790975	U6	-	104	49296
chr7	80751142	80752870	1728	chr7	80790871	80790975	U6	-	104	38001
chr7	80762471	80764478	2007	chr7	80790871	80790975	U6	-	104	26393
chr7	80772316	80773487	1171	chr7	80790871	80790975	U6	-	104	17384
chr7	81828075	81829075	1000	chr7	81420305	81699666	Slco3a1	-	279361	128409
chr7	82506278	82507916	1638	chr7	82453588	82476305	1500012K07Rik	+	22717	29973
chr7	82515043	82517215	2172	chr7	82453588	82476305	1500012K07Rik	+	22717	38738
chr7	82532453	82534120	1667	chr7	82453588	82476305	1500012K07Rik	+	22717	56148
chr7	82560779	82561779	1000	chr7	82600420	82899495	Akap13	+	299075	38641
chr7	82918741	82920862	2121	chr7	82902145	82902254	AC158749.1	-	109	16487
chr7	82924065	82926022	1957	chr7	82902145	82902254	AC158749.1	-	109	21811
chr7	82929923	82932258	2335	chr7	82902145	82902254	AC158749.1	-	109	27669
chr7	82937828	82942351	4523	chr7	82902145	82902254	AC158749.1	-	109	35574
chr7	82966101	82967585	1484	chr7	82993224	83019016	Klhl25	+	25792	25639
chr7	83044053	83045215	1162	chr7	82993224	83019016	Klhl25	+	25792	25037
chr7	87286619	87292281	5662	chr7	87297706	87297765	AC164075.1	-	59	5425
chr7	87304927	87306999	2072	chr7	87297776	87297901	Mir1965	-	125	7026
chr7	87310709	87312636	1927	chr7	87297776	87297901	Mir1965	-	125	12808
chr7	87323799	87326368	2569	chr7	87331727	87371280	Sema4b	+	39553	5359
chr7	87561130	87562812	1682	chr7	87533471	87550322	Furin	-	16851	10808
chr7	87699157	87701208	2051	chr7	87599879	87680005	Blm	-	80126	19152
chr7	87720114	87721219	1105	chr7	87731513	87833763	Crtc3	-	102250	10294
chr7	87973327	87978514	5187	chr7	87856469	87948217	Iqgap1	-	91748	25110
chr7	88131491	88132491	1000	chr7	88138567	88190050	Zfp592	+	51483	6076
chr7	88993217	88995171	1954	chr7	89000419	89000680	Gm10160	-	261	5248
chr7	89161516	89163750	2234	chr7	89136888	89137504	4833418N17Rik	+	616	24012
chr7	89173927	89175861	1934	chr7	89136888	89137504	4833418N17Rik	+	616	36423
chr7	89958810	89960592	1782	chr7	89797124	89926362	Eftud1	+	129238	32448
chr7	90119326	90121088	1762	chr7	90143345	90143476	SNORA17	+	131	22257
chr7	90409923	90411390	1467	chr7	90297154	90304432	A530021J07Rik	+	7278	105491
chr7	90712788	90713846	1058	chr7	90697653	90698138	Gm10610	-	485	14650
chr7	90975008	90976028	1020	chr7	90922611	90943390	1700026D08Rik	-	20779	31618
chr7	90977052	90978841	1789	chr7	90922611	90943390	1700026D08Rik	-	20779	33662
chr7	91000671	91001724	1053	chr7	91029005	91032851	Mesdc1	-	3846	27281
chr7	95332938	95335134	2196	chr7	94750952	95283417	Grm5	+	532465	49521
chr7	95340179	95342692	2513	chr7	94750952	95283417	Grm5	+	532465	56762
chr7	95373924	95375125	1201	chr7	95426595	95459398	Ctsc	+	32803	51470
chr7	95377234	95380228	2994	chr7	95426595	95459398	Ctsc	+	32803	46367
chr7	95398721	95399843	1122	chr7	95426595	95459398	Ctsc	+	32803	26752
chr7	97155063	97156665	1602	chr7	97103166	97129493	Eed	-	26327	25570
chr7	97167547	97169252	1705	chr7	97103166	97129493	Eed	-	26327	38054
chr7	97182115	97183487	1372	chr7	97103166	97129493	Eed	-	26327	52622
chr7	97203017	97204220	1203	chr7	97255987	97256478	Gm5341	-	491	51767
chr7	97215455	97217406	1951	chr7	97255987	97256478	Gm5341	-	491	38581
chr7	97450493	97451493	1000	chr7	97442244	97442356	n-R5s155	+	112	8137
chr7	99641436	99643087	1651	chr7	97650473	99595513	Dlg2	+	1945040	45923
chr7	104577586	104579152	1566	chr7	104561448	104566240	Thrsp	-	4792	11346
chr7	104579901	104581847	1946	chr7	104561448	104566240	Thrsp	-	4792	13661
chr7	104582285	104583285	1000	chr7	104561448	104566240	Thrsp	-	4792	16045
chr7	105489791	105490800	1009	chr7	105499178	105509838	Tsku	-	10660	8378
chr7	105679322	105681078	1756	chr7	105691888	105711498	A630091E08Rik	-	19610	10810
chr7	105682242	105684040	1798	chr7	105691888	105711498	A630091E08Rik	-	19610	7848
chr7	105952502	105953502	1000	chr7	105983622	106003705	Wnt11	+	20083	30120
chr7	105963083	105964946	1863	chr7	105983622	106003705	Wnt11	+	20083	18676
chr7	106295293	106296465	1172	chr7	106035253	106289654	Uvrag	-	254401	5639
chr7	106507938	106509829	1891	chr7	106493885	106501740	Serpinh1	-	7855	6198
chr7	106942980	106945201	2221	chr7	106928511	106929998	F730035P03Rik	-	1487	12982
chr7	108199053	108200877	1824	chr7	108145086	108160505	P2ry2	-	15419	38548
chr7	108205631	108206733	1102	chr7	108145086	108160505	P2ry2	-	15419	45126
chr7	108206881	108207881	1000	chr7	108145086	108160505	P2ry2	-	15419	46376
chr7	108208316	108209901	1585	chr7	108257289	108432919	Fchsd2	+	175630	47388
chr7	108218903	108221204	2301	chr7	108257289	108432919	Fchsd2	+	175630	36085
chr7	108231507	108232507	1000	chr7	108257289	108432919	Fchsd2	+	175630	24782
chr7	108240651	108242706	2055	chr7	108257289	108432919	Fchsd2	+	175630	14583
chr7	108458639	108460268	1629	chr7	108465600	108495140	Stard10	+	29540	5332
chr7	108999726	109000818	1092	chr7	108988512	108993831	Folr2	-	5319	5895
chr7	109661180	109662722	1542	chr7	109669011	109669538	Gm8556	-	527	6289
chr7	111008581	111010420	1839	chr7	111000259	111001754	Hbb-y	-	1495	6827
chr7	112729346	112730346	1000	chr7	112707000	112722916	Apbb1	-	15916	6430
chr7	113671496	113674195	2699	chr7	113654053	113655185	Gm8995	-	1132	16311
chr7	113760266	113761266	1000	chr7	113744757	113747549	Gm1966	-	2792	12717
chr7	113767531	113768557	1026	chr7	113744757	113747549	Gm1966	-	2792	19982
chr7	113783652	113786173	2521	chr7	113821048	113821999	Olfr693	-	951	34875
chr7	113786383	113787383	1000	chr7	113821048	113821999	Olfr693	-	951	33665
chr7	113795354	113797062	1708	chr7	113821048	113821999	Olfr693	-	951	23986
chr7	117251790	117253667	1877	chr7	117265864	117285626	Wee1	+	19762	12197
chr7	117299986	117302667	2681	chr7	117265864	117285626	Wee1	+	19762	14360
chr7	117307583	117308715	1132	chr7	117265864	117285626	Wee1	+	19762	21957
chr7	117308939	117309939	1000	chr7	117265864	117285626	Wee1	+	19762	23313
chr7	117322918	117326587	3669	chr7	117265864	117285626	Wee1	+	19762	37292
chr7	117327671	117329759	2088	chr7	117365217	117427017	Swap70	+	61800	35458
chr7	117333126	117334700	1574	chr7	117365217	117427017	Swap70	+	61800	30517
chr7	117345412	117347634	2222	chr7	117365217	117427017	Swap70	+	61800	17583
chr7	117788811	117789811	1000	chr7	117771175	117773331	Adm	+	2156	15480
chr7	117832211	117833749	1538	chr7	117771175	117773331	Adm	+	2156	58880
chr7	118265462	118267169	1707	chr7	118211499	118226544	Eif4g2	-	15045	38918
chr7	120340589	120341698	1109	chr7	120350979	120457636	Arntl	+	106657	9281
chr7	120648154	120650019	1865	chr7	120657348	120715025	Far1	+	57677	7329
chr7	121314674	121316598	1924	chr7	121359073	121398225	Copb1	-	39152	42475
chr7	121337260	121338260	1000	chr7	121359073	121398225	Copb1	-	39152	20813
chr7	121434807	121436894	2087	chr7	121408120	121419632	Psma1	-	11512	15175
chr7	121440748	121441748	1000	chr7	121458993	121558675	4933406I18Rik	-	99682	17245
chr7	121443768	121446079	2311	chr7	121458993	121558675	4933406I18Rik	-	99682	12914
chr7	122183515	122184515	1000	chr7	122080059	122080376	7SK	+	317	103139
chr7	123599765	123603674	3909	chr7	123480790	123586972	Pik3c2a	-	106182	12793
chr7	123636422	123638691	2269	chr7	123647888	123684098	Nucb2	+	36210	9197
chr7	124233753	124235757	2004	chr7	124096103	124096209	U6	-	106	137544
chr7	124251224	124252248	1024	chr7	124096103	124096209	U6	-	106	155015
chr7	124269736	124272348	2612	chr7	124096103	124096209	U6	-	106	173527
chr7	125124907	125125939	1032	chr7	125247892	125259700	Rps15a	-	11808	121953
chr7	125489266	125490981	1715	chr7	125525370	125587066	Syt17	-	61696	34389
chr7	127973652	127975145	1493	chr7	127986345	128050733	Eef2k	+	64388	11200
chr7	129390627	129391736	1109	chr7	129408608	129408714	U6	+	106	16872
chr7	129394150	129395824	1674	chr7	129408608	129408714	U6	+	106	12784
chr7	129399189	129401173	1984	chr7	129408608	129408714	U6	+	106	7435
chr7	129963981	129964981	1000	chr7	129815258	129912905	Cacng3	+	97647	51076
chr7	130063126	130064771	1645	chr7	130109200	130146071	Rbbp6	+	36871	44429
chr7	130066254	130069810	3556	chr7	130109200	130146071	Rbbp6	+	36871	39390
chr7	130083198	130084812	1614	chr7	130109200	130146071	Rbbp6	+	36871	24388
chr7	132563680	132564680	1000	chr7	132588190	132605779	Jmjd5	+	17589	23510
chr7	132565988	132567476	1488	chr7	132588190	132605779	Jmjd5	+	17589	20714
chr7	132654195	132655913	1718	chr7	132611154	132635110	Nsmce1	-	23956	19085
chr7	132685605	132687338	1733	chr7	132695785	132722986	Il4ra	+	27201	8447
chr7	132731380	132734078	2698	chr7	132695785	132722986	Il4ra	+	27201	8394
chr7	132736716	132737738	1022	chr7	132746943	132777084	Il21r	+	30141	9205
chr7	132740578	132741579	1001	chr7	132746943	132777084	Il21r	+	30141	5364
chr7	133379220	133380440	1220	chr7	133245229	133344015	Xpo6	-	98786	35205
chr7	133745445	133746445	1000	chr7	133732524	133738455	Il27	-	5931	6990
chr7	134306507	134310713	4206	chr7	134334541	134334753	AC122537.1	+	212	23828
chr7	135191645	135194744	3099	chr7	135205219	135205374	U1	-	155	10475
chr7	135475791	135477436	1645	chr7	135414893	135441684	BC017158	-	26791	34107
chr7	135721128	135722610	1482	chr7	135667097	135690491	Bag3	+	23394	30637
chr7	136902818	136904599	1781	chr7	136735377	136779252	Wdr11	+	43875	123566
chr7	136941073	136944063	2990	chr7	136735377	136779252	Wdr11	+	43875	161821
chr7	136956870	136958755	1885	chr7	136735377	136779252	Wdr11	+	43875	177618
chr7	140648514	140650002	1488	chr7	140778707	140793798	4930404H21Rik	-	15091	128705
chr7	142680329	142682595	2266	chr7	142703149	142720337	Clrn3	-	17188	20554
chr7	144766006	144769081	3075	chr7	144629331	144660277	Glrx3	+	30946	105729
chr7	144775854	144778002	2148	chr7	144629331	144660277	Glrx3	+	30946	115577
chr7	144784806	144785975	1169	chr7	144629331	144660277	Glrx3	+	30946	124529
chr7	145057192	145059691	2499	chr7	145293116	145293222	U6	-	106	233425
chr7	146110659	146112104	1445	chr7	146082519	146101202	Bnip3	-	18683	9457
chr7	146562709	146563709	1000	chr7	146575008	146765551	Inpp5a	+	190543	11299
chr7	148173015	148174150	1135	chr7	148153120	148155724	Ifitm1	+	2604	17291
chr7	148176615	148177615	1000	chr7	148195485	148196669	Ifitm3	-	1184	17870
chr7	148184336	148185336	1000	chr7	148195485	148196669	Ifitm3	-	1184	10149
chr7	148557695	148558826	1131	chr7	148545040	148551009	B230206H07Rik	-	5969	6686
chr7	152295958	152297770	1812	chr7	152439828	152469916	Tpcn2	-	30088	142058
chr7	3546215	3547594	1379	chr7	3561415	3567759	Oscar	-	6344	13821
chr7	3891795	3892795	1000	chr7	3859882	3867105	Lilra6	-	7223	24690
chr7	11363893	11365137	1244	chr7	11332851	11334887	Vmn1r71	-	2036	29006
chr7	11631475	11632475	1000	chr7	11591071	11595896	Zscan4c	+	4825	35579
chr7	16631643	16632750	1107	chr7	16657291	16681677	Zfp541	+	24386	24541
chr7	16633610	16635138	1528	chr7	16657291	16681677	Zfp541	+	24386	22153
chr7	16880155	16881201	1046	chr7	16859391	16872144	Ccdc9	-	12753	8011
chr7	20429435	20431008	1573	chr7	20437352	20443696	Gm19345	+	6344	6344
chr7	26390932	26392512	1580	chr7	26399640	26400911	Gm7092	-	1271	7128
chr7	29215520	29216520	1000	chr7	29222466	29233252	Gmfg	+	10786	5946
chr7	31720702	31721702	1000	chr7	31727390	31729036	Hamp	-	1646	5688
chr7	31785631	31786697	1066	chr7	31758823	31774739	Fam187b	+	15916	10892
chr7	38875847	38876847	1000	chr7	38883003	38892553	Ccne1	-	9550	6156
chr7	50235398	50236592	1194	chr7	50219953	50222192	Gm2302	-	2239	13206
chr7	50810466	50811466	1000	chr7	50817626	50830831	Zfp658	+	13205	6160
chr7	54271758	54273183	1425	chr7	54245766	54263781	Spty2d1	-	18015	7977
chr7	54287267	54288267	1000	chr7	54306010	54310146	Tmem86a	+	4136	17743
chr7	54395314	54396450	1136	chr7	54333168	54389054	Ptpn5	-	55886	6260
chr7	55392610	55394227	1617	chr7	55423353	55424384	Mrgprb5	-	1031	29126
chr7	56173317	56174317	1000	chr7	56133328	56141978	Gm2788	+	8650	31339
chr7	57126899	57128672	1773	chr7	57033716	57113635	Prmt3	+	79919	13264
chr7	71286126	71287303	1177	chr7	71298721	71414661	Trpm1	+	115940	11418
chr7	73343105	73344639	1534	chr7	73254401	73318675	Chsy1	+	64274	24430
chr7	74565908	74566908	1000	chr7	74376049	74517744	Mef2a	-	141695	48164
chr7	74574650	74575650	1000	chr7	74376049	74517744	Mef2a	-	141695	56906
chr7	74589725	74591070	1345	chr7	74658297	74790122	Lrrc28	-	131825	67227
chr7	80697250	80698293	1043	chr7	80571577	80686632	Chd2	-	115055	10618
chr7	80703544	80704720	1176	chr7	80571577	80686632	Chd2	-	115055	16912
chr7	80724372	80725372	1000	chr7	80571577	80686632	Chd2	-	115055	37740
chr7	82926242	82927273	1031	chr7	82902145	82902254	AC158749.1	-	109	23988
chr7	82933325	82935399	2074	chr7	82902145	82902254	AC158749.1	-	109	31071
chr7	85864444	85865444	1000	chr7	85920122	85928417	Mrpl46	-	8295	54678
chr7	88027876	88028876	1000	chr7	88005806	88021402	Zscan2	+	15596	6474
chr7	91006512	91007957	1445	chr7	91029005	91032851	Mesdc1	-	3846	21048
chr7	95355148	95356326	1178	chr7	95426595	95459398	Ctsc	+	32803	70269
chr7	97171528	97172607	1079	chr7	97103166	97129493	Eed	-	26327	42035
chr7	97208348	97209465	1117	chr7	97255987	97256478	Gm5341	-	491	46522
chr7	104897182	104898332	1150	chr7	104874889	104886757	Aqp11	-	11868	10425
chr7	105635100	105636140	1040	chr7	105642732	105650341	Lrrc32	+	7609	6592
chr7	108215363	108216363	1000	chr7	108257289	108432919	Fchsd2	+	175630	40926
chr7	108243490	108244490	1000	chr7	108257289	108432919	Fchsd2	+	175630	12799
chr7	113379722	113381266	1544	chr7	113300049	113358854	Gvin1	-	58805	20868
chr7	113694654	113696535	1881	chr7	113654053	113655185	Gm8995	-	1132	39469
chr7	113787423	113788547	1124	chr7	113821048	113821999	Olfr693	-	951	32501
chr7	117320025	117321025	1000	chr7	117265864	117285626	Wee1	+	19762	34399
chr7	120277565	120278565	1000	chr7	120263212	120263322	5S_rRNA	+	110	14243
chr7	122094288	122095384	1096	chr7	122080059	122080376	7SK	+	317	13912
chr7	123627727	123628727	1000	chr7	123647888	123684098	Nucb2	+	36210	19161
chr7	125125943	125126984	1041	chr7	125247892	125259700	Rps15a	-	11808	120908
chr7	127978276	127980140	1864	chr7	127986345	128050733	Eef2k	+	64388	6205
chr7	130251916	130253193	1277	chr7	130267770	130338802	Tnrc6a	+	71032	14577
chr7	132643717	132644817	1100	chr7	132611154	132635110	Nsmce1	-	23956	8607
chr7	142927404	142928404	1000	chr7	142881471	142908062	Mki67	-	26591	19342
chr7	146481675	146482675	1000	chr7	146434381	146453152	Pwwp2b	+	18771	28523
chr8	3981427	3983265	1838	chr8	3940222	3954746	Cd209c	-	14524	26681
chr8	4403223	4404223	1000	chr8	4325210	4360020	Ccl25	+	34810	43203
chr8	4611466	4613422	1956	chr8	4625840	4629380	Zfp958	+	3540	12418
chr8	6481446	6482446	1000	chr8	6223819	6223962	SNORA48	-	143	257484
chr8	9007470	9009868	2398	chr8	9207238	9771018	Fam155a	-	563780	197370
chr8	10830111	10833611	3500	chr8	10924427	10928457	3930402G23Rik	-	4030	90816
chr8	10839696	10840696	1000	chr8	10924427	10928457	3930402G23Rik	-	4030	83731
chr8	10871774	10872870	1096	chr8	10924427	10928457	3930402G23Rik	-	4030	51557
chr8	10900788	10901895	1107	chr8	10924427	10928457	3930402G23Rik	-	4030	22532
chr8	11097370	11098744	1374	chr8	11007850	11054541	9530052E02Rik	+	46691	42829
chr8	11111993	11114000	2007	chr8	11007850	11054541	9530052E02Rik	+	46691	57452
chr8	11114911	11115911	1000	chr8	11007850	11054541	9530052E02Rik	+	46691	60370
chr8	11137686	11138686	1000	chr8	11187755	11204503	Gm15418	+	16748	49069
chr8	11579450	11581578	2128	chr8	11556066	11563250	Ing1	+	7184	16200
chr8	13212065	13214481	2416	chr8	13175162	13200620	Grtp1	-	25458	11445
chr8	13684808	13685903	1095	chr8	13566950	13677603	Rasa3	-	110653	7205
chr8	14873116	14874116	1000	chr8	14881335	14901720	Cln8	+	20385	7219
chr8	18898476	18899535	1059	chr8	18846277	18891361	Agpat5	+	45084	7115
chr8	23724648	23725761	1113	chr8	23734515	23738008	Dkk4	+	3493	8754
chr8	23948697	23949840	1143	chr8	23932900	23933017	U6	-	117	15680
chr8	26228366	26229856	1490	chr8	26149616	26212666	Plekha2	-	63050	15700
chr8	26242115	26243945	1830	chr8	26265024	26311921	Tacc1	-	46897	21079
chr8	26350704	26351704	1000	chr8	26265024	26311921	Tacc1	-	46897	38783
chr8	26384595	26386482	1887	chr8	26265024	26311921	Tacc1	-	46897	72674
chr8	27279082	27280082	1000	chr8	27268684	27273412	Thap1	+	4728	5670
chr8	27945650	27947357	1707	chr8	28087808	28091933	Zfp703	+	4125	140451
chr8	27996625	27997997	1372	chr8	28087808	28091933	Zfp703	+	4125	89811
chr8	28061776	28065555	3779	chr8	28087808	28091933	Zfp703	+	4125	22253
chr8	28073122	28074856	1734	chr8	28087808	28091933	Zfp703	+	4125	12952
chr8	34580894	34582543	1649	chr8	34539181	34540020	5930422O12Rik	+	839	40874
chr8	35270556	35272074	1518	chr8	35217617	35233899	Tmem66	+	16282	36657
chr8	35338262	35340053	1791	chr8	35358910	35359030	AC134443.1	-	120	18857
chr8	35447688	35449324	1636	chr8	35390964	35391407	Gm4889	+	443	56281
chr8	35460133	35461184	1051	chr8	35390964	35391407	Gm4889	+	443	68726
chr8	35547366	35549904	2538	chr8	35390964	35391407	Gm4889	+	443	155959
chr8	35653406	35655043	1637	chr8	35870351	35882948	Dusp4	+	12597	215308
chr8	35670003	35671588	1585	chr8	35870351	35882948	Dusp4	+	12597	198763
chr8	35684861	35687736	2875	chr8	35870351	35882948	Dusp4	+	12597	182615
chr8	35751298	35753415	2117	chr8	35870351	35882948	Dusp4	+	12597	116936
chr8	35758608	35759608	1000	chr8	35870351	35882948	Dusp4	+	12597	110743
chr8	35765309	35767183	1874	chr8	35870351	35882948	Dusp4	+	12597	103168
chr8	35788493	35790357	1864	chr8	35870351	35882948	Dusp4	+	12597	79994
chr8	35802167	35804266	2099	chr8	35870351	35882948	Dusp4	+	12597	66085
chr8	35806069	35808458	2389	chr8	35870351	35882948	Dusp4	+	12597	61893
chr8	35809724	35810884	1160	chr8	35870351	35882948	Dusp4	+	12597	59467
chr8	35857886	35859464	1578	chr8	35870351	35882948	Dusp4	+	12597	10887
chr8	35860548	35861988	1440	chr8	35870351	35882948	Dusp4	+	12597	8363
chr8	36185801	36186842	1041	chr8	36028106	36029263	Gm9939	+	1157	156538
chr8	36491451	36492528	1077	chr8	36528319	36558587	Eri1	-	30268	35791
chr8	36493168	36494390	1222	chr8	36528319	36558587	Eri1	-	30268	33929
chr8	36770752	36771764	1012	chr8	36650852	36742503	Mfhas1	+	91651	28249
chr8	36922698	36924433	1735	chr8	36887766	36889613	Cldn23	-	1847	33085
chr8	37078701	37080218	1517	chr8	37088807	37089190	Gm10063	+	383	8589
chr8	37227153	37228219	1066	chr8	37157882	37210841	D8Ertd82e	+	52959	16312
chr8	37235470	37236470	1000	chr8	37157882	37210841	D8Ertd82e	+	52959	24629
chr8	37244511	37246199	1688	chr8	37279118	37312570	Lonrf1	-	33452	32919
chr8	37254410	37257808	3398	chr8	37279118	37312570	Lonrf1	-	33452	21310
chr8	41480186	41481842	1656	chr8	41392812	41471662	Efha2	+	78850	8524
chr8	43278498	43279498	1000	chr8	43332189	43332805	Gm6180	+	616	52691
chr8	47480122	47481177	1055	chr8	47556395	47621405	Acsl1	+	65010	75218
chr8	47518978	47519978	1000	chr8	47556395	47621405	Acsl1	+	65010	36417
chr8	47740449	47742253	1804	chr8	47702803	47724060	Casp3	+	21257	16389
chr8	47771963	47773001	1038	chr8	47816326	47824869	Gm16675	-	8543	43325
chr8	47791363	47793120	1757	chr8	47816326	47824869	Gm16675	-	8543	23206
chr8	47797458	47800844	3386	chr8	47816326	47824869	Gm16675	-	8543	15482
chr8	47944667	47945964	1297	chr8	47825099	47932812	Irf2	+	107713	11855
chr8	47954527	47955700	1173	chr8	47825099	47932812	Irf2	+	107713	21715
chr8	47966019	47967899	1880	chr8	47825099	47932812	Irf2	+	107713	33207
chr8	47998861	48000825	1964	chr8	47825099	47932812	Irf2	+	107713	66049
chr8	48013890	48015689	1799	chr8	48072279	48180249	Enpp6	+	107970	56590
chr8	48025799	48026809	1010	chr8	48072279	48180249	Enpp6	+	107970	45470
chr8	48036805	48039232	2427	chr8	48072279	48180249	Enpp6	+	107970	33047
chr8	56167502	56168502	1000	chr8	56040081	56146231	Gpm6a	+	106150	21271
chr8	60138047	60140479	2432	chr8	60002625	60131829	Galnt7	-	129204	6218
chr8	63345382	63347683	2301	chr8	63333022	63333092	AC154909.1	-	70	12290
chr8	63903365	63906558	3193	chr8	63702669	63874869	Sh3rf1	+	172200	28496
chr8	63929211	63930608	1397	chr8	63966531	63982279	Cbr4	+	15748	35923
chr8	63953584	63954584	1000	chr8	63966531	63982279	Cbr4	+	15748	11947
chr8	70644392	70646341	1949	chr8	70212981	70586185	Psd3	-	373204	58207
chr8	70649081	70652020	2939	chr8	70212981	70586185	Psd3	-	373204	62896
chr8	70681065	70682172	1107	chr8	70742072	70752312	Gm17236	-	10240	59900
chr8	70769687	70770893	1206	chr8	70742072	70752312	Gm17236	-	10240	17375
chr8	71449063	71451346	2283	chr8	71404390	71431347	Lpl	+	26957	17716
chr8	71716428	71718183	1755	chr8	71689644	71708114	Gm7677	-	18470	8314
chr8	71732069	71733690	1621	chr8	71750242	71752879	Zfp930	+	2637	16552
chr8	71794698	71797573	2875	chr8	71824675	71827061	D130040H23Rik	+	2386	27102
chr8	72107410	72108410	1000	chr8	72134756	72149447	Zfp868	-	14691	26346
chr8	72240136	72241834	1698	chr8	72230231	72234623	Zfp869	-	4392	5513
chr8	72526672	72527859	1187	chr8	72430968	72520278	Gatad2a	-	89310	6394
chr8	74302962	74305156	2194	chr8	74232286	74249615	Fcho1	-	17329	53347
chr8	74541024	74543283	2259	chr8	74512381	74533525	Cyp4f18	-	21144	7499
chr8	74602322	74603997	1675	chr8	74623661	74624605	Olfr373	+	944	19664
chr8	74609513	74610513	1000	chr8	74623661	74624605	Olfr373	+	944	13148
chr8	74790271	74793870	3599	chr8	74763917	74781284	Ap1m1	+	17367	8987
chr8	74793877	74796750	2873	chr8	74763917	74781284	Ap1m1	+	17367	12593
chr8	74808433	74809433	1000	chr8	74828009	74829159	Gm10282	-	1150	18576
chr8	74853986	74855567	1581	chr8	74842932	74845555	Klf2	+	2623	8431
chr8	77605071	77608223	3152	chr8	77617490	77624495	Hmox1	+	7005	9267
chr8	82136058	82138224	2166	chr8	82163517	82201654	Otud4	+	38137	25293
chr8	85653967	85656065	2098	chr8	85688980	85690069	Gm10645	-	1089	32915
chr8	85664507	85666591	2084	chr8	85688980	85690069	Gm10645	-	1089	22389
chr8	86710179	86711327	1148	chr8	86702762	86702867	Mir181c	-	105	7312
chr8	86715693	86717339	1646	chr8	86702762	86702867	Mir181c	-	105	12826
chr8	86724461	86725461	1000	chr8	86732417	86732491	Mir23a	+	74	6956
chr8	88093657	88094657	1000	chr8	88061539	88079170	Dnaja2	-	17631	14487
chr8	88125611	88127581	1970	chr8	88161136	88224653	Neto2	-	63517	33555
chr8	89280747	89283020	2273	chr8	89269598	89270502	Gm10638	+	904	10245
chr8	89302217	89303840	1623	chr8	89269598	89270502	Gm10638	+	904	31715
chr8	89434344	89436154	1810	chr8	89365038	89409157	N4bp1	-	44119	25187
chr8	93318609	93320791	2182	chr8	93352734	93578407	Chd9	+	225673	31943
chr8	96236209	96237209	1000	chr8	96274047	96334192	Gm16615	-	60145	36838
chr8	96709860	96711665	1805	chr8	96702989	96704225	Mt1	+	1236	5635
chr8	96713830	96716227	2397	chr8	96702989	96704225	Mt1	+	1236	9605
chr8	96966370	96968395	2025	chr8	96946799	96959005	9330175E14Rik	-	12206	7365
chr8	96970493	96973483	2990	chr8	96946799	96959005	9330175E14Rik	-	12206	11488
chr8	96981280	96983597	2317	chr8	96996663	97051172	Nlrc5	+	54509	13066
chr8	97326447	97328673	2226	chr8	97334353	97335935	Ccl17	+	1582	5680
chr8	97477659	97479470	1811	chr8	97488579	97493656	Gm10286	-	5077	9109
chr8	97677675	97679732	2057	chr8	97623732	97666440	Kifc3	-	42708	11235
chr8	97913935	97916156	2221	chr8	97876168	97898193	Mmp15	+	22025	15742
chr8	107094299	107095437	1138	chr8	107115368	107120736	Pdp2	+	5368	19931
chr8	108020237	108021256	1019	chr8	107996325	108008330	Zdhhc1	-	12005	11907
chr8	108119659	108121205	1546	chr8	108129129	108146094	Fam65a	+	16965	7924
chr8	108151194	108154851	3657	chr8	108129129	108146094	Fam65a	+	16965	5100
chr8	109663097	109664097	1000	chr8	109674561	109711370	Cyb5b	+	36809	10464
chr8	112273760	112274947	1187	chr8	112250351	112261639	Atxn1l	-	11288	12121
chr8	116508674	116510846	2172	chr8	116221026	116372641	Adamts18	-	151615	136033
chr8	117920991	117923167	2176	chr8	116963555	117876608	Wwox	+	913053	44383
chr8	118866813	118868793	1980	chr8	118912950	118913013	U7	+	63	44157
chr8	119076081	119077387	1306	chr8	119098301	119256891	Cdyl2	-	158590	20914
chr8	119748329	119749361	1032	chr8	119682035	119729734	Gan	+	47699	18595
chr8	119993648	119995432	1784	chr8	119780919	119985403	4933407C03Rik	+	204484	8245
chr8	119998902	120001146	2244	chr8	119780919	119985403	4933407C03Rik	+	204484	13499
chr8	120003424	120004917	1493	chr8	120022191	120159040	Plcg2	+	136849	17274
chr8	120005136	120006243	1107	chr8	120022191	120159040	Plcg2	+	136849	15948
chr8	120303250	120307226	3976	chr8	120315545	120325829	Mphosph6	-	10284	8319
chr8	121947032	121950375	3343	chr8	121958024	121970156	Osgin1	+	12132	7649
chr8	122307611	122308999	1388	chr8	122284487	122302316	4632415K11Rik	-	17829	5295
chr8	128054939	128056603	1664	chr8	127941963	128016610	Sipa1l2	-	74647	38329
chr8	128081995	128084266	2271	chr8	127941963	128016610	Sipa1l2	-	74647	65385
chr8	128091646	128092646	1000	chr8	127941963	128016610	Sipa1l2	-	74647	75036
chr8	129126915	129127915	1000	chr8	129112196	129117336	Irf2bp2	-	5140	9579
chr8	129137264	129140481	3217	chr8	129112196	129117336	Irf2bp2	-	5140	19928
chr8	129175546	129176957	1411	chr8	129112196	129117336	Irf2bp2	-	5140	58210
chr8	129189489	129191959	2470	chr8	129112196	129117336	Irf2bp2	-	5140	72153
chr8	129222561	129223903	1342	chr8	129112196	129117336	Irf2bp2	-	5140	105225
chr8	129245363	129246820	1457	chr8	129112196	129117336	Irf2bp2	-	5140	128027
chr8	129281664	129282928	1264	chr8	129112196	129117336	Irf2bp2	-	5140	164328
chr8	129302662	129304268	1606	chr8	129458043	129469723	Tomm20	-	11680	153775
chr8	129317063	129318932	1869	chr8	129458043	129469723	Tomm20	-	11680	139111
chr8	129321090	129323846	2756	chr8	129458043	129469723	Tomm20	-	11680	134197
chr8	129326466	129328475	2009	chr8	129458043	129469723	Tomm20	-	11680	129568
chr8	129329334	129330334	1000	chr8	129458043	129469723	Tomm20	-	11680	127709
chr8	129337665	129338665	1000	chr8	129458043	129469723	Tomm20	-	11680	119378
chr8	129341836	129347900	6064	chr8	129458043	129469723	Tomm20	-	11680	110143
chr8	129348002	129352408	4406	chr8	129458043	129469723	Tomm20	-	11680	105635
chr8	129352751	129357422	4671	chr8	129458043	129469723	Tomm20	-	11680	100621
chr8	129370755	129371755	1000	chr8	129458043	129469723	Tomm20	-	11680	86288
chr8	129378254	129379254	1000	chr8	129458043	129469723	Tomm20	-	11680	78789
chr8	129390489	129392599	2110	chr8	129458043	129469723	Tomm20	-	11680	65444
chr8	129396669	129397669	1000	chr8	129458043	129469723	Tomm20	-	11680	60374
chr8	129404595	129405595	1000	chr8	129458043	129469723	Tomm20	-	11680	52448
chr8	129410117	129411120	1003	chr8	129458043	129469723	Tomm20	-	11680	46923
chr8	129418301	129420334	2033	chr8	129458043	129469723	Tomm20	-	11680	37709
chr8	129443189	129445277	2088	chr8	129458043	129469723	Tomm20	-	11680	12766
chr8	130338123	130339643	1520	chr8	129587793	130136186	Pard3	+	548393	201937
chr8	130600870	130603715	2845	chr8	130870807	130870971	Gm17350	-	164	267092
chr8	130627308	130628308	1000	chr8	130870807	130870971	Gm17350	-	164	242499
chr8	130634491	130635491	1000	chr8	130870807	130870971	Gm17350	-	164	235316
chr8	130688866	130690406	1540	chr8	130870807	130870971	Gm17350	-	164	180401
chr8	8994031	8995031	1000	chr8	9207238	9771018	Fam155a	-	563780	212207
chr8	10945684	10946885	1201	chr8	10924427	10928457	3930402G23Rik	-	4030	17227
chr8	11107263	11108376	1113	chr8	11007850	11054541	9530052E02Rik	+	46691	52722
chr8	13686362	13687494	1132	chr8	13566950	13677603	Rasa3	-	110653	8759
chr8	23832932	23833932	1000	chr8	23769684	23817061	Ikbkb	-	47377	15871
chr8	26219281	26223132	3851	chr8	26149616	26212666	Plekha2	-	63050	6615
chr8	35078725	35079793	1068	chr8	35112316	35120100	Gm9951	+	7784	32523
chr8	35667816	35668816	1000	chr8	35870351	35882948	Dusp4	+	12597	201535
chr8	35725539	35726596	1057	chr8	35870351	35882948	Dusp4	+	12597	143755
chr8	35734806	35735906	1100	chr8	35870351	35882948	Dusp4	+	12597	134445
chr8	35795317	35796425	1108	chr8	35870351	35882948	Dusp4	+	12597	73926
chr8	35818660	35820374	1714	chr8	35870351	35882948	Dusp4	+	12597	49977
chr8	35827855	35828855	1000	chr8	35870351	35882948	Dusp4	+	12597	41496
chr8	37122922	37123922	1000	chr8	37088807	37089190	Gm10063	+	383	33732
chr8	37221469	37222786	1317	chr8	37157882	37210841	D8Ertd82e	+	52959	10628
chr8	37228534	37229534	1000	chr8	37157882	37210841	D8Ertd82e	+	52959	17693
chr8	37251682	37252682	1000	chr8	37279118	37312570	Lonrf1	-	33452	26436
chr8	47421612	47422666	1054	chr8	47377404	47380025	Helt	-	2621	41587
chr8	47971687	47972687	1000	chr8	47825099	47932812	Irf2	+	107713	38875
chr8	48017380	48018903	1523	chr8	48072279	48180249	Enpp6	+	107970	53376
chr8	48019691	48020786	1095	chr8	48072279	48180249	Enpp6	+	107970	51493
chr8	48028763	48029828	1065	chr8	48072279	48180249	Enpp6	+	107970	42451
chr8	48775739	48776869	1130	chr8	48760745	48762409	AA386476	+	1664	13330
chr8	55360958	55361958	1000	chr8	55162886	55271808	Vegfc	+	108922	89150
chr8	70770942	70773731	2789	chr8	70742072	70752312	Gm17236	-	10240	18630
chr8	71644991	71646055	1064	chr8	71612545	71637610	Atp6v1b2	+	25065	7381
chr8	74797035	74799000	1965	chr8	74763917	74781284	Ap1m1	+	17367	15751
chr8	74819313	74821437	2124	chr8	74828009	74829159	Gm10282	-	1150	6572
chr8	85676381	85677494	1113	chr8	85688980	85690069	Gm10645	-	1089	11486
chr8	86721554	86724096	2542	chr8	86732417	86732491	Mir23a	+	74	8321
chr8	89322000	89323783	1783	chr8	89365038	89409157	N4bp1	-	44119	41255
chr8	90142776	90144455	1679	chr8	90160556	90160912	7SK	+	356	16101
chr8	97227872	97231290	3418	chr8	97221916	97222185	7SK	-	269	5687
chr8	111215780	111216964	1184	chr8	111238544	111485536	Zfhx3	+	246992	21580
chr8	111227868	111228868	1000	chr8	111238544	111485536	Zfhx3	+	246992	9676
chr8	127867865	127868865	1000	chr8	127941963	128016610	Sipa1l2	-	74647	73098
chr8	128092688	128094675	1987	chr8	127941963	128016610	Sipa1l2	-	74647	76078
chr8	128223489	128224489	1000	chr8	128193718	128197265	4933403G14Rik	+	3547	26224
chr8	129279577	129280577	1000	chr8	129112196	129117336	Irf2bp2	-	5140	162241
chr8	129362765	129363770	1005	chr8	129458043	129469723	Tomm20	-	11680	94273
chr8	129372120	129373265	1145	chr8	129458043	129469723	Tomm20	-	11680	84778
chr8	129379850	129380850	1000	chr8	129458043	129469723	Tomm20	-	11680	77193
chr8	129399200	129400262	1062	chr8	129458043	129469723	Tomm20	-	11680	57781
chr8	129420412	129421631	1219	chr8	129458043	129469723	Tomm20	-	11680	36412
chr8	131059638	131060638	1000	chr8	130882973	131029362	Nrp1	+	146389	30276
chr9	4358625	4361033	2408	chr9	4371269	4371335	CT030685.2	-	66	10236
chr9	7220410	7222489	2079	chr9	7184566	7207031	Dcun1d5	+	22465	13379
chr9	7713913	7715118	1205	chr9	7692086	7699585	Mmp7	+	7499	14328
chr9	7732637	7736255	3618	chr9	7751725	7752207	Gm10709	+	482	15470
chr9	7737498	7739545	2047	chr9	7751725	7752207	Gm10709	+	482	12180
chr9	7741967	7744226	2259	chr9	7751725	7752207	Gm10709	+	482	7499
chr9	11380391	11381924	1533	chr9	11070288	11070397	CT009748.1	+	109	309994
chr9	11512893	11514805	1912	chr9	11070288	11070397	CT009748.1	+	109	442496
chr9	11671265	11672265	1000	chr9	11070288	11070397	CT009748.1	+	109	600868
chr9	11847217	11850313	3096	chr9	11070288	11070397	CT009748.1	+	109	776820
chr9	13269588	13272011	2423	chr9	13234581	13235956	Phxr4	+	1375	33632
chr9	13272151	13274510	2359	chr9	13234581	13235956	Phxr4	+	1375	36195
chr9	13286834	13287933	1099	chr9	13234581	13235956	Phxr4	+	1375	50878
chr9	13340527	13341564	1037	chr9	13424434	13513832	Maml2	+	89398	82870
chr9	13344828	13345828	1000	chr9	13424434	13513832	Maml2	+	89398	78606
chr9	13357596	13359654	2058	chr9	13424434	13513832	Maml2	+	89398	64780
chr9	13359943	13365047	5104	chr9	13424434	13513832	Maml2	+	89398	59387
chr9	13366966	13368493	1527	chr9	13424434	13513832	Maml2	+	89398	55941
chr9	13390933	13392245	1312	chr9	13424434	13513832	Maml2	+	89398	32189
chr9	13878253	13879253	1000	chr9	14080745	14130582	Sesn3	+	49837	201492
chr9	13891942	13893256	1314	chr9	14080745	14130582	Sesn3	+	49837	187489
chr9	13893967	13896035	2068	chr9	14080745	14130582	Sesn3	+	49837	184710
chr9	13897184	13898502	1318	chr9	14080745	14130582	Sesn3	+	49837	182243
chr9	13951293	13952293	1000	chr9	14080745	14130582	Sesn3	+	49837	128452
chr9	13978911	13980612	1701	chr9	14080745	14130582	Sesn3	+	49837	100133
chr9	14066603	14067715	1112	chr9	14080745	14130582	Sesn3	+	49837	13030
chr9	14730398	14732080	1682	chr9	14690258	14708395	Folr4	-	18137	22003
chr9	15453413	15455064	1651	chr9	15364308	15432377	Ccdc67	-	68069	21036
chr9	21131580	21133681	2101	chr9	21142288	21159469	Slc44a2	+	17181	8607
chr9	21705347	21706451	1104	chr9	21711935	21722636	Rab3d	-	10701	5484
chr9	21947280	21948280	1000	chr9	21931175	21940190	Acp5	-	9015	7090
chr9	22018131	22019131	1000	chr9	22011785	22012990	1810064F22Rik	-	1205	5141
chr9	22020574	22022494	1920	chr9	22011785	22012990	1810064F22Rik	-	1205	7584
chr9	22111370	22112934	1564	chr9	22125549	22125821	Gm10182	-	272	12615
chr9	24979050	24980783	1733	chr9	24912574	24956280	Herpud2	-	43706	22770
chr9	24989856	24991271	1415	chr9	24912574	24956280	Herpud2	-	43706	33576
chr9	25034533	25035647	1114	chr9	25056204	25116150	Sept7	+	59946	20557
chr9	31055091	31056091	1000	chr9	31078495	31078590	snoU13	-	95	22404
chr9	32367467	32370587	3120	chr9	32229793	32348974	Fli1	-	119181	18493
chr9	32399201	32400541	1340	chr9	32443806	32565405	Ets1	+	121599	43265
chr9	32416785	32419130	2345	chr9	32443806	32565405	Ets1	+	121599	24676
chr9	32422597	32424563	1966	chr9	32443806	32565405	Ets1	+	121599	19243
chr9	32424955	32425955	1000	chr9	32443806	32565405	Ets1	+	121599	17851
chr9	32571988	32572988	1000	chr9	32443806	32565405	Ets1	+	121599	6583
chr9	32682386	32684372	1986	chr9	32443806	32565405	Ets1	+	121599	116981
chr9	32713289	32714618	1329	chr9	32443806	32565405	Ets1	+	121599	147884
chr9	32722468	32724529	2061	chr9	32443806	32565405	Ets1	+	121599	157063
chr9	32747588	32748705	1117	chr9	32443806	32565405	Ets1	+	121599	182183
chr9	33290126	33292723	2597	chr9	33535831	33536436	Gm10698	+	605	243108
chr9	35130577	35133438	2861	chr9	35089103	35089420	Gm5614	-	317	41157
chr9	40389617	40390650	1033	chr9	40338740	40341205	Gm17540	+	2465	48412
chr9	40446150	40447188	1038	chr9	40494045	40593402	9030425E11Rik	+	99357	46857
chr9	41015422	41016432	1010	chr9	40819181	40969780	Ubash3b	-	150599	45642
chr9	41020068	41021326	1258	chr9	40819181	40969780	Ubash3b	-	150599	50288
chr9	41036728	41037728	1000	chr9	40819181	40969780	Ubash3b	-	150599	66948
chr9	41439105	41440881	1776	chr9	41283020	41423263	D230004N17Rik	+	140243	15842
chr9	41758218	41759671	1453	chr9	41772803	41932380	Sorl1	-	159577	13132
chr9	41945899	41947329	1430	chr9	41772803	41932380	Sorl1	-	159577	13519
chr9	41949020	41951598	2578	chr9	41772803	41932380	Sorl1	-	159577	16640
chr9	41953415	41955742	2327	chr9	41772803	41932380	Sorl1	-	159577	21035
chr9	42016237	42017406	1169	chr9	42062260	42072383	Sc5d	-	10123	44854
chr9	42021556	42023144	1588	chr9	42062260	42072383	Sc5d	-	10123	39116
chr9	42046481	42047481	1000	chr9	42062260	42072383	Sc5d	-	10123	14779
chr9	43352579	43353579	1000	chr9	43552659	43615537	Pvrl1	+	62878	199080
chr9	44300816	44302177	1361	chr9	44307219	44318471	Bcl9l	+	11252	5042
chr9	44340638	44342240	1602	chr9	44319871	44334504	Cxcr5	-	14633	6134
chr9	44345212	44349367	4155	chr9	44319871	44334504	Cxcr5	-	14633	10708
chr9	44373312	44374413	1101	chr9	44412975	44448814	Ddx6	+	35839	38562
chr9	44374987	44376559	1572	chr9	44412975	44448814	Ddx6	+	35839	36416
chr9	44378503	44380201	1698	chr9	44412975	44448814	Ddx6	+	35839	32774
chr9	44382497	44383497	1000	chr9	44412975	44448814	Ddx6	+	35839	29478
chr9	44389425	44390604	1179	chr9	44412975	44448814	Ddx6	+	35839	22371
chr9	44400570	44402099	1529	chr9	44412975	44448814	Ddx6	+	35839	10876
chr9	44462591	44464349	1758	chr9	44412975	44448814	Ddx6	+	35839	13777
chr9	44837911	44838911	1000	chr9	44850508	44862098	Mpzl2	+	11590	11597
chr9	45099177	45100370	1193	chr9	45061920	45077232	Il10ra	-	15312	21945
chr9	45101572	45103345	1773	chr9	45126348	45130162	1700003G13Rik	-	3814	23003
chr9	45105993	45108245	2252	chr9	45126348	45130162	1700003G13Rik	-	3814	18103
chr9	46949747	46952194	2447	chr9	47333699	47333805	U6	-	106	381505
chr9	48224864	48227621	2757	chr9	48169509	48207981	Fam55d	+	38472	16883
chr9	48228027	48231457	3430	chr9	48169509	48207981	Fam55d	+	38472	20046
chr9	48240346	48241346	1000	chr9	48258501	48258887	Gm5616	+	386	17155
chr9	48251955	48253019	1064	chr9	48258501	48258887	Gm5616	+	386	5482
chr9	48365805	48368445	2640	chr9	48399982	48413258	Nnmt	-	13276	31537
chr9	50270470	50271470	1000	chr9	50302630	50313744	1600029D21Rik	+	11114	31160
chr9	50837717	50842208	4491	chr9	50862745	50885199	Layn	-	22454	20537
chr9	50969885	50972005	2120	chr9	50924106	50927980	Btg4	+	3874	41905
chr9	50972292	50974297	2005	chr9	50924106	50927980	Btg4	+	3874	44312
chr9	50975825	50976825	1000	chr9	51021795	51048184	Pou2af1	+	26389	44970
chr9	51002335	51003335	1000	chr9	51021795	51048184	Pou2af1	+	26389	18460
chr9	51012193	51014526	2333	chr9	51021795	51048184	Pou2af1	+	26389	7269
chr9	51909999	51912050	2051	chr9	51920090	51976216	Zc3h12c	-	56126	8040
chr9	51982061	51983184	1123	chr9	51920090	51976216	Zc3h12c	-	56126	5845
chr9	51983511	51984511	1000	chr9	51920090	51976216	Zc3h12c	-	56126	7295
chr9	51989027	51990530	1503	chr9	51920090	51976216	Zc3h12c	-	56126	12811
chr9	51995768	51997498	1730	chr9	51920090	51976216	Zc3h12c	-	56126	19552
chr9	52010664	52011664	1000	chr9	51920090	51976216	Zc3h12c	-	56126	34448
chr9	52025313	52026313	1000	chr9	51920090	51976216	Zc3h12c	-	56126	49097
chr9	52036910	52039599	2689	chr9	52099304	52099436	SNORA17	+	132	59705
chr9	52041301	52043529	2228	chr9	52099304	52099436	SNORA17	+	132	55775
chr9	52044586	52047079	2493	chr9	52099304	52099436	SNORA17	+	132	52225
chr9	52047240	52048253	1013	chr9	52099304	52099436	SNORA17	+	132	51051
chr9	52068841	52070696	1855	chr9	52099304	52099436	SNORA17	+	132	28608
chr9	52078865	52079865	1000	chr9	52099304	52099436	SNORA17	+	132	19439
chr9	52085387	52087191	1804	chr9	52099304	52099436	SNORA17	+	132	12113
chr9	52088221	52090086	1865	chr9	52099304	52099436	SNORA17	+	132	9218
chr9	52156494	52158362	1868	chr9	52099304	52099436	SNORA17	+	132	57058
chr9	52164039	52165039	1000	chr9	52099304	52099436	SNORA17	+	132	64603
chr9	55922927	55924277	1350	chr9	55889652	55909689	Rcn2	+	20037	13238
chr9	56030657	56032709	2052	chr9	56048938	56265857	C230081A13Rik	-	216919	16229
chr9	56353782	56355070	1288	chr9	56266451	56344691	Hmg20a	+	78240	9091
chr9	56397512	56398512	1000	chr9	56266451	56344691	Hmg20a	+	78240	52821
chr9	57124538	57126593	2055	chr9	57100129	57110406	1700017B05Rik	-	10277	14132
chr9	57128853	57130558	1705	chr9	57100129	57110406	1700017B05Rik	-	10277	18447
chr9	57164652	57166151	1499	chr9	57181920	57182598	Gm5121	+	678	15769
chr9	57193150	57194150	1000	chr9	57181920	57182598	Gm5121	+	678	10552
chr9	57502849	57504457	1608	chr9	57474454	57493460	Csk	-	19006	9389
chr9	57711257	57715467	4210	chr9	57638160	57684600	Arid3b	-	46440	26657
chr9	57721347	57722728	1381	chr9	57758793	57777775	Ubl7	+	18982	36065
chr9	57735772	57737008	1236	chr9	57758793	57777775	Ubl7	+	18982	21785
chr9	57747861	57750475	2614	chr9	57758793	57777775	Ubl7	+	18982	8318
chr9	57819051	57820937	1886	chr9	57787920	57810671	Sema7a	+	22751	8380
chr9	57821525	57824195	2670	chr9	57787920	57810671	Sema7a	+	22751	10854
chr9	58115973	58116973	1000	chr9	58100971	58110330	Stoml1	+	9359	5643
chr9	58121582	58124181	2599	chr9	58100971	58110330	Stoml1	+	9359	11252
chr9	58125990	58128779	2789	chr9	58135530	58161019	Loxl1	-	25489	6751
chr9	58355258	58356258	1000	chr9	58338044	58347494	6030419C18Rik	+	9450	7764
chr9	58357012	58359213	2201	chr9	58338044	58347494	6030419C18Rik	+	9450	9518
chr9	60838730	60840379	1649	chr9	60642355	60728177	Uaca	+	85822	110553
chr9	60860343	60861986	1643	chr9	60642355	60728177	Uaca	+	85822	132166
chr9	60901598	60903365	1767	chr9	60642355	60728177	Uaca	+	85822	173421
chr9	61063008	61065018	2010	chr9	61218604	61220000	Gm10655	-	1396	153586
chr9	61069449	61071405	1956	chr9	61218604	61220000	Gm10655	-	1396	147199
chr9	61072757	61074610	1853	chr9	61218604	61220000	Gm10655	-	1396	143994
chr9	61090554	61091554	1000	chr9	61218604	61220000	Gm10655	-	1396	127050
chr9	61098798	61100637	1839	chr9	61218604	61220000	Gm10655	-	1396	117967
chr9	61326680	61327791	1111	chr9	61220190	61266297	Tle3	+	46107	60383
chr9	61474839	61476642	1803	chr9	61220190	61266297	Tle3	+	46107	208542
chr9	61509713	61511737	2024	chr9	61220190	61266297	Tle3	+	46107	243416
chr9	61514062	61515774	1712	chr9	61761091	61762345	Rplp1	-	1254	245317
chr9	61527280	61528503	1223	chr9	61761091	61762345	Rplp1	-	1254	232588
chr9	61549379	61551031	1652	chr9	61761091	61762345	Rplp1	-	1254	210060
chr9	61554216	61556794	2578	chr9	61761091	61762345	Rplp1	-	1254	204297
chr9	61674088	61676753	2665	chr9	61761091	61762345	Rplp1	-	1254	84338
chr9	61676769	61678587	1818	chr9	61761091	61762345	Rplp1	-	1254	82504
chr9	61887079	61890734	3655	chr9	61801288	61874663	Paqr5	-	73375	12416
chr9	61898579	61899579	1000	chr9	61905055	61918413	Glce	-	13358	5476
chr9	62069412	62071347	1935	chr9	62090570	62090674	AC113291.1	-	104	19223
chr9	62941106	62943174	2068	chr9	62981090	62981196	U6	+	106	37916
chr9	62971361	62972361	1000	chr9	62981090	62981196	U6	+	106	8729
chr9	63632780	63634459	1679	chr9	63494574	63605801	Smad3	-	111227	26979
chr9	64627127	64628306	1179	chr9	64659147	64767474	Dennd4a	+	108327	30841
chr9	64637025	64638224	1199	chr9	64659147	64767474	Dennd4a	+	108327	20923
chr9	64644642	64646206	1564	chr9	64659147	64767474	Dennd4a	+	108327	12941
chr9	65371644	65372644	1000	chr9	65349260	65364806	Ankdd1a	-	15546	6838
chr9	65382314	65383328	1014	chr9	65349260	65364806	Ankdd1a	-	15546	17508
chr9	65392653	65393716	1063	chr9	65402193	65427847	Plekho2	-	25654	8477
chr9	66131144	66132144	1000	chr9	66006030	66120049	Dapk2	+	114019	11095
chr9	66152496	66154706	2210	chr9	66006030	66120049	Dapk2	+	114019	32447
chr9	66446578	66449770	3192	chr9	66362444	66440949	Usp3	-	78505	5629
chr9	66452860	66454696	1836	chr9	66362444	66440949	Usp3	-	78505	11911
chr9	66462343	66463536	1193	chr9	66362444	66440949	Usp3	-	78505	21394
chr9	66530381	66531381	1000	chr9	66561493	66614652	Car12	+	53159	30112
chr9	66836109	66840165	4056	chr9	66828895	66828992	U6	-	97	7117
chr9	67006933	67009580	2647	chr9	66952015	66952162	U1	+	147	54771
chr9	67481488	67482549	1061	chr9	67064894	67407510	Tln2	-	342616	73978
chr9	67646366	67647835	1469	chr9	67678339	67680137	C2cd4a	-	1798	30504
chr9	67661470	67662578	1108	chr9	67678339	67680137	C2cd4a	-	1798	15761
chr9	69548564	69552128	3564	chr9	69605517	69608747	Foxb1	-	3230	53389
chr9	69787578	69788578	1000	chr9	69837273	69856124	Bnip2	+	18851	48695
chr9	69926502	69928291	1789	chr9	69937117	69990367	Fam81a	-	53250	8826
chr9	70518840	70520945	2105	chr9	70526804	70628036	Adam10	+	101232	5859
chr9	71035213	71037303	2090	chr9	70958466	71016489	Aqp9	-	58023	18724
chr9	71980431	71981771	1340	chr9	71969613	71969711	U6	-	98	10720
chr9	72487312	72488683	1371	chr9	72481254	72481360	U6	+	106	5952
chr9	74782377	74784133	1756	chr9	74800691	74880275	BC031353	+	79584	16558
chr9	75281821	75284089	2268	chr9	75289331	75314239	Leo1	+	24908	5242
chr9	77408192	77410767	2575	chr9	77425521	77425596	AC157995.1	+	75	14754
chr9	77445699	77446717	1018	chr9	77425521	77425596	AC157995.1	+	75	20103
chr9	77654020	77655042	1022	chr9	77602342	77642292	Gclc	+	39950	11728
chr9	77837620	77838620	1000	chr9	77765171	77832326	Elovl5	+	67155	5294
chr9	77839274	77840274	1000	chr9	77765171	77832326	Elovl5	+	67155	6948
chr9	77869337	77871053	1716	chr9	77861779	77861905	SNORA17	-	126	7432
chr9	78368132	78369851	1719	chr9	78384295	78435848	Slc17a5	-	51553	14444
chr9	78374411	78376210	1799	chr9	78384295	78435848	Slc17a5	-	51553	8085
chr9	79582864	79583864	1000	chr9	79446798	79566638	Col12a1	-	119840	16226
chr9	79903721	79907656	3935	chr9	79914710	79992760	Senp6	+	78050	7054
chr9	82901284	82904586	3302	chr9	82759766	82869096	Phip	-	109330	32188
chr9	82916047	82918191	2144	chr9	82759766	82869096	Phip	-	109330	46951
chr9	82936323	82937799	1476	chr9	83003555	83040292	Hmgn3	-	36737	65756
chr9	82987924	82989506	1582	chr9	83003555	83040292	Hmgn3	-	36737	14049
chr9	83193533	83195017	1484	chr9	83283900	83334734	Lca5	-	50834	88883
chr9	83340960	83342135	1175	chr9	83283900	83334734	Lca5	-	50834	6226
chr9	83378690	83379893	1203	chr9	83283900	83334734	Lca5	-	50834	43956
chr9	83552128	83553154	1026	chr9	83441934	83532408	Sh3bgrl2	+	90474	19720
chr9	88135788	88136788	1000	chr9	88222447	88266927	Nt5e	+	44480	85659
chr9	88190596	88194047	3451	chr9	88222447	88266927	Nt5e	+	44480	28400
chr9	89721355	89722722	1367	chr9	89697098	89697166	Mir184	-	68	24189
chr9	89725748	89727696	1948	chr9	89697098	89697166	Mir184	-	68	28582
chr9	89737209	89738282	1073	chr9	89697098	89697166	Mir184	-	68	40043
chr9	89767553	89770474	2921	chr9	89804613	89921814	Rasgrf1	+	117201	34139
chr9	90020439	90021528	1089	chr9	89986509	90009658	Morf4l1	-	23149	10781
chr9	92123534	92125225	1691	chr9	92144895	92166813	Plscr1	+	21918	19670
chr9	94331982	94333744	1762	chr9	94418283	94438500	1190002N15Rik	-	20217	84539
chr9	95179206	95180606	1400	chr9	94570328	95130864	Slc9a9	+	560536	48342
chr9	95250072	95252229	2157	chr9	95301348	95307689	Chst2	-	6341	49119
chr9	95253557	95255561	2004	chr9	95301348	95307689	Chst2	-	6341	45787
chr9	96292846	96294834	1988	chr9	96233099	96264766	Atp1b3	-	31667	28080
chr9	96299071	96301200	2129	chr9	96233099	96264766	Atp1b3	-	31667	34305
chr9	96569484	96571361	1877	chr9	96583182	96653250	Zbtb38	-	70068	11821
chr9	96575398	96576999	1601	chr9	96583182	96653250	Zbtb38	-	70068	6183
chr9	96658877	96659988	1111	chr9	96583182	96653250	Zbtb38	-	70068	5627
chr9	96665552	96666825	1273	chr9	96583182	96653250	Zbtb38	-	70068	12302
chr9	96695611	96696671	1060	chr9	96723763	96793088	Acpl2	-	69325	27092
chr9	96699977	96702174	2197	chr9	96723763	96793088	Acpl2	-	69325	21589
chr9	104171521	104172988	1467	chr9	104053927	104165260	Dnajc13	-	111333	6261
chr9	106296209	106297585	1376	chr9	106270963	106278055	Dusp7	+	7092	18154
chr9	106308262	106309992	1730	chr9	106331785	106333899	Rpl29	+	2114	21793
chr9	106312933	106313933	1000	chr9	106331785	106333899	Rpl29	+	2114	17852
chr9	107214461	107215461	1000	chr9	107198357	107205115	Cish	+	6758	9346
chr9	109764857	109766774	1917	chr9	109778083	109796392	Cdc25a	+	18309	11309
chr9	109816030	109817030	1000	chr9	109833962	109986451	Mtap4	+	152489	16932
chr9	110969436	110970436	1000	chr9	110977898	110977960	U7	+	62	7462
chr9	114580856	114581856	1000	chr9	114597908	114633420	Dync1li1	+	35512	16052
chr9	114952275	114954772	2497	chr9	114976397	115141341	Osbpl10	+	164944	21625
chr9	115299699	115300925	1226	chr9	115291217	115291339	AC161265.2	+	122	8360
chr9	115387981	115389353	1372	chr9	115346818	115347699	Gm5921	-	881	40282
chr9	115397132	115398847	1715	chr9	115346818	115347699	Gm5921	-	881	49433
chr9	115401352	115402397	1045	chr9	115346818	115347699	Gm5921	-	881	53653
chr9	115407830	115408930	1100	chr9	115346818	115347699	Gm5921	-	881	60131
chr9	115492008	115493008	1000	chr9	115535718	115535836	n-R5s92	-	118	42710
chr9	115520217	115522202	1985	chr9	115535718	115535836	n-R5s92	-	118	13516
chr9	116098723	116100085	1362	chr9	115993415	116084383	Tgfbr2	-	90968	14340
chr9	116107103	116108255	1152	chr9	115993415	116084383	Tgfbr2	-	90968	22720
chr9	116124279	116126144	1865	chr9	115993415	116084383	Tgfbr2	-	90968	39896
chr9	116131891	116132961	1070	chr9	115993415	116084383	Tgfbr2	-	90968	47508
chr9	116202270	116203646	1376	chr9	115993415	116084383	Tgfbr2	-	90968	117887
chr9	116227624	116234464	6840	chr9	115993415	116084383	Tgfbr2	-	90968	143241
chr9	116235508	116238729	3221	chr9	115993415	116084383	Tgfbr2	-	90968	151125
chr9	116241048	116244126	3078	chr9	115993415	116084383	Tgfbr2	-	90968	156665
chr9	116246782	116250343	3561	chr9	115993415	116084383	Tgfbr2	-	90968	162399
chr9	116274620	116278636	4016	chr9	115993415	116084383	Tgfbr2	-	90968	190237
chr9	116297354	116299182	1828	chr9	116481864	117539031	Rbms3	-	1057167	182682
chr9	117810861	117812293	1432	chr9	117782262	117790320	Gm16977	+	8058	20541
chr9	118313867	118315636	1769	chr9	118376102	118376182	U4	-	80	60466
chr9	119897311	119898724	1413	chr9	119880284	119886368	Csrnp1	-	6084	10943
chr9	119904424	119905736	1312	chr9	119922873	119932716	Xirp1	-	9843	17137
chr9	119910544	119913103	2559	chr9	119922873	119932716	Xirp1	-	9843	9770
chr9	120684507	120686731	2224	chr9	120700583	120700903	7SK	-	320	13852
chr9	121789788	121790788	1000	chr9	121807473	121820182	Ccbp2	+	12709	16685
chr9	121833521	121837161	3640	chr9	121823474	121825423	Cyp8b1	-	1949	8098
chr9	122783508	122785413	1905	chr9	122794198	122812302	A530083I20Rik	-	18104	8785
chr9	123779401	123780627	1226	chr9	123761436	123771246	Xcr1	-	9810	8155
chr9	123781170	123782481	1311	chr9	123761436	123771246	Xcr1	-	9810	9924
chr9	123847747	123849898	2151	chr9	123836860	123839608	Gm4694	+	2748	8139
chr9	123903807	123905450	1643	chr9	123891782	123893241	Ccr1l1	-	1459	10566
chr9	13404194	13405194	1000	chr9	13424434	13513832	Maml2	+	89398	19240
chr9	15297813	15298959	1146	chr9	15309931	15349704	BC017612	+	39773	10972
chr9	19426364	19427523	1159	chr9	19445668	19452492	Zfp317	+	6824	18145
chr9	21125898	21129308	3410	chr9	21099901	21116777	Ap1m2	-	16876	9121
chr9	22019196	22020213	1017	chr9	22011785	22012990	1810064F22Rik	-	1205	6206
chr9	25000280	25002183	1903	chr9	24912574	24956280	Herpud2	-	43706	44000
chr9	31051134	31052134	1000	chr9	31078495	31078590	snoU13	-	95	26361
chr9	31060456	31062509	2053	chr9	31078495	31078590	snoU13	-	95	15986
chr9	32378017	32379017	1000	chr9	32229793	32348974	Fli1	-	119181	29043
chr9	32389263	32390365	1102	chr9	32229793	32348974	Fli1	-	119181	40289
chr9	32420419	32421559	1140	chr9	32443806	32565405	Ets1	+	121599	22247
chr9	37591239	37592311	1072	chr9	37580222	37581225	Olfr875	+	1003	10014
chr9	42017447	42018515	1068	chr9	42062260	42072383	Sc5d	-	10123	43745
chr9	45088053	45089072	1019	chr9	45061920	45077232	Il10ra	-	15312	10821
chr9	45108491	45109662	1171	chr9	45126348	45130162	1700003G13Rik	-	3814	16686
chr9	50983635	50984875	1240	chr9	51021795	51048184	Pou2af1	+	26389	36920
chr9	50990764	50992301	1537	chr9	51021795	51048184	Pou2af1	+	26389	29494
chr9	52079909	52081235	1326	chr9	52099304	52099436	SNORA17	+	132	18069
chr9	55785161	55786235	1074	chr9	55397690	55767412	Scaper	-	369722	17749
chr9	57121322	57123005	1683	chr9	57100129	57110406	1700017B05Rik	-	10277	10916
chr9	57187752	57188752	1000	chr9	57181920	57182598	Gm5121	+	678	5154
chr9	57709781	57710781	1000	chr9	57638160	57684600	Arid3b	-	46440	25181
chr9	60846139	60847968	1829	chr9	60642355	60728177	Uaca	+	85822	117962
chr9	60983296	60984296	1000	chr9	61218604	61220000	Gm10655	-	1396	234308
chr9	61466429	61467429	1000	chr9	61220190	61266297	Tle3	+	46107	200132
chr9	61511914	61513019	1105	chr9	61220190	61266297	Tle3	+	46107	245617
chr9	61517348	61518348	1000	chr9	61761091	61762345	Rplp1	-	1254	242743
chr9	61528957	61530777	1820	chr9	61761091	61762345	Rplp1	-	1254	230314
chr9	65383547	65384743	1196	chr9	65402193	65427847	Plekho2	-	25654	17450
chr9	65389350	65390410	1060	chr9	65402193	65427847	Plekho2	-	25654	11783
chr9	66128248	66129313	1065	chr9	66006030	66120049	Dapk2	+	114019	8199
chr9	70865902	70866902	1000	chr9	70645936	70800033	Lipc	-	154097	65869
chr9	74757109	74759331	2222	chr9	74709728	74739282	Onecut1	+	29554	17827
chr9	76570730	76571730	1000	chr9	76564435	76564554	SNORA17	-	119	6176
chr9	77399073	77400073	1000	chr9	77278630	77392677	Lrrc1	-	114047	6396
chr9	77574153	77575153	1000	chr9	77602342	77642292	Gclc	+	39950	27189
chr9	77758388	77759577	1189	chr9	77765171	77832326	Elovl5	+	67155	5594
chr9	81202214	81203758	1544	chr9	80849043	81097197	Gm17255	+	248154	105017
chr9	82930744	82933142	2398	chr9	82759766	82869096	Phip	-	109330	61648
chr9	83243826	83244826	1000	chr9	83283900	83334734	Lca5	-	50834	39074
chr9	85250916	85252068	1152	chr9	85214046	85220731	Fam46a	-	6685	30185
chr9	89397188	89398291	1103	chr9	89484876	89517824	AF529169	-	32948	86585
chr9	96550312	96551372	1060	chr9	96439719	96532036	Rasa2	-	92317	18276
chr9	104183389	104184389	1000	chr9	104190581	104240058	Acpp	-	49477	6192
chr9	107210332	107211557	1225	chr9	107198357	107205115	Cish	+	6758	5217
chr9	109825749	109826835	1086	chr9	109833962	109986451	Mtap4	+	152489	7127
chr9	114389452	114390452	1000	chr9	114310194	114383495	Glb1	+	73301	5957
chr9	115398934	115399970	1036	chr9	115346818	115347699	Gm5921	-	881	51235
chr9	115408970	115409970	1000	chr9	115346818	115347699	Gm5921	-	881	61271
chr9	115517625	115518731	1106	chr9	115535718	115535836	n-R5s92	-	118	16987
chr9	115563943	115564943	1000	chr9	115535718	115535836	n-R5s92	-	118	28107
chr9	116128628	116130635	2007	chr9	115993415	116084383	Tgfbr2	-	90968	44245
chr9	116152823	116153978	1155	chr9	115993415	116084383	Tgfbr2	-	90968	68440
chr9	116292704	116294364	1660	chr9	116481864	117539031	Rbms3	-	1057167	187500
chr9	117836041	117837121	1080	chr9	117856918	117923278	Zcwpw2	-	66360	19797
chr9	119891998	119893005	1007	chr9	119880284	119886368	Csrnp1	-	6084	5630
chr9	121194222	121195727	1505	chr9	120869386	121186315	Ulk4	-	316929	7907
chr9	121837904	121838904	1000	chr9	121847253	121856132	1700048O20Rik	+	8879	8349
chr9	123974492	123975650	1158	chr9	123936703	123946421	Ccr3	+	9718	28071
chr9	123983031	123985161	2130	chr9	124016689	124028296	Ccr2	+	11607	31528
chrX	8716150	8717816	1666	chrX	8700578	8701126	Gm5753	+	548	15024
chrX	9247707	9249504	1797	chrX	9231393	9240129	Dynlt3	-	8736	7578
chrX	11207511	11210148	2637	chrX	11178480	11178695	Gm14515	+	215	28816
chrX	11230081	11231081	1000	chrX	11261128	11261250	Gm14513	-	122	30047
chrX	11292772	11294756	1984	chrX	11261128	11261250	Gm14513	-	122	31522
chrX	11329562	11331537	1975	chrX	11261128	11261250	Gm14513	-	122	68312
chrX	11352733	11354711	1978	chrX	11427610	11427716	U6	+	106	72899
chrX	11384027	11385469	1442	chrX	11427610	11427716	U6	+	106	42141
chrX	11405972	11407023	1051	chrX	11427610	11427716	U6	+	106	20587
chrX	11416048	11418131	2083	chrX	11427610	11427716	U6	+	106	9479
chrX	11467908	11470560	2652	chrX	11490217	11490415	Gm14491	-	198	19657
chrX	11575626	11577217	1591	chrX	11561601	11561776	Gm14512	+	175	13850
chrX	11581754	11583796	2042	chrX	11561601	11561776	Gm14512	+	175	19978
chrX	11590929	11593096	2167	chrX	11613866	11737481	Bcor	-	123615	20770
chrX	11771822	11773058	1236	chrX	11756844	11757193	Gm14521	-	349	14629
chrX	11828631	11830528	1897	chrX	11756844	11757193	Gm14521	-	349	71438
chrX	12807134	12808758	1624	chrX	12815453	12816679	Gm16481	+	1226	6695
chrX	12887873	12888873	1000	chrX	12879411	12881546	Gm5380	+	2135	6327
chrX	12923318	12925342	2024	chrX	12903149	12904145	Gm7129	-	996	19173
chrX	19878236	19879236	1000	chrX	19682881	19868933	Slc9a7	-	186052	9303
chrX	19882957	19885256	2299	chrX	19682881	19868933	Slc9a7	-	186052	14024
chrX	19931828	19933476	1648	chrX	19941607	19982779	Rp2h	+	41172	8131
chrX	34347115	34348178	1063	chrX	34354766	34357195	Gm14549	+	2429	6588
chrX	39370561	39371575	1014	chrX	39412856	39462833	Xiap	+	49977	41281
chrX	45667651	45668836	1185	chrX	45660220	45660320	U6	+	100	7331
chrX	48157655	48159809	2154	chrX	48194224	48246274	2610018G03Rik	+	52050	34415
chrX	56838538	56839658	1120	chrX	56315322	56821248	Fgf13	-	505926	17290
chrX	68776770	68779519	2749	chrX	68762411	68765281	Gm17665	+	2870	11489
chrX	71352633	71354307	1674	chrX	71372803	71396099	Opn1mw	+	23296	18496
chrX	71360485	71361525	1040	chrX	71372803	71396099	Opn1mw	+	23296	11278
chrX	72918534	72919592	1058	chrX	72950748	72951020	Gm15065	+	272	31156
chrX	74677976	74679552	1576	chrX	74701925	74702567	Gm5937	+	642	22373
chrX	91422037	91424274	2237	chrX	91434046	91458201	Eif2s3x	-	24155	9772
chrX	93162594	93164299	1705	chrX	93130674	93152301	Las1l	-	21627	10293
chrX	93220983	93222149	1166	chrX	93130674	93152301	Las1l	-	21627	68682
chrX	98527066	98529231	2165	chrX	98491178	98521302	Nlgn3	+	30124	5764
chrX	103330144	103332501	2357	chrX	103338543	103355832	Tlr13	+	17289	6042
chrX	104412294	104414058	1764	chrX	104428669	104429139	Gm14836	+	470	14611
chrX	104520109	104521445	1336	chrX	104539925	104540951	Gm14833	+	1026	18480
chrX	104524646	104526178	1532	chrX	104539925	104540951	Gm14833	+	1026	13747
chrX	110980840	110982610	1770	chrX	110991940	110992063	SNORA17	-	123	9330
chrX	127083128	127084332	1204	chrX	127095992	127096433	Gm14982	-	441	11660
chrX	130907851	130909878	2027	chrX	130842623	130897178	Cenpi	+	54555	10673
chrX	137039724	137041370	1646	chrX	136991152	137010679	Prps1	+	19527	29045
chrX	137045125	137046783	1658	chrX	137074067	137135198	Tsc22d3	-	61131	27284
chrX	137054018	137056060	2042	chrX	137074067	137135198	Tsc22d3	-	61131	18007
chrX	146912196	146913214	1018	chrX	146898269	146900699	3110067C02Rik	+	2430	11497
chrX	150321182	150322820	1638	chrX	150349659	150349758	U6	-	99	26839
chrX	155945880	155947081	1201	chrX	155852504	155936879	Mtap7d2	+	84375	9001
chrX	155947977	155949274	1297	chrX	155852504	155936879	Mtap7d2	+	84375	11098
chrX	162667835	162668835	1000	chrX	162676843	162826920	Gpm6b	+	150077	8008
chrX	163154994	163156977	1983	chrX	163099957	163127744	Gm1720	+	27787	27250
chrX	163242985	163244344	1359	chrX	163292134	163292985	Rpl7a-ps11	+	851	47790
chrX	163245478	163246533	1055	chrX	163292134	163292985	Rpl7a-ps11	+	851	45601
chrX	163546258	163548639	2381	chrX	163526025	163540022	Gm15232	-	13997	6236
chrX	163548683	163551231	2548	chrX	163526025	163540022	Gm15232	-	13997	8661
chrX	163555288	163558796	3508	chrX	163526025	163540022	Gm15232	-	13997	15266
chrX	163568325	163572009	3684	chrX	163526025	163540022	Gm15232	-	13997	28303
chrX	163583281	163585521	2240	chrX	163602029	163609210	Gm15228	+	7181	16508
chrX	163617624	163619136	1512	chrX	163602029	163609210	Gm15228	+	7181	8414
chrX	163620078	163621333	1255	chrX	163602029	163609210	Gm15228	+	7181	10868
chrX	163664416	163665732	1316	chrX	163680626	163702261	Tlr8	-	21635	14894
chrX	163666042	163669764	3722	chrX	163680626	163702261	Tlr8	-	21635	10862
chrX	163670339	163671609	1270	chrX	163680626	163702261	Tlr8	-	21635	9017
chrX	163776949	163779252	2303	chrX	163784254	163820681	Prps2	-	36427	5002
chrX	165834061	165835903	1842	chrX	165806121	165807935	BC022960	+	1814	26126
chrX	11241612	11242726	1114	chrX	11261128	11261250	Gm14513	-	122	18402
chrX	11242828	11244264	1436	chrX	11261128	11261250	Gm14513	-	122	16864
chrX	11254783	11255783	1000	chrX	11261128	11261250	Gm14513	-	122	5345
chrX	11458067	11459067	1000	chrX	11444391	11444831	Rpl23a-ps13	+	440	13236
chrX	11584050	11585050	1000	chrX	11561601	11561776	Gm14512	+	175	22274
chrX	12434733	12436062	1329	chrX	12447395	12447488	AL662925.1	-	93	11333
chrX	18860089	18861089	1000	chrX	18932127	18932233	U6	+	106	71038
chrX	18861221	18862221	1000	chrX	18932127	18932233	U6	+	106	69906
chrX	34660109	34661109	1000	chrX	34666790	34690741	Nkap	+	23951	5681
chrX	54435869	54436869	1000	chrX	54453820	54457555	Gm14718	+	3735	16951
chrX	58975516	58976646	1130	chrX	58962789	58964124	Ldoc1	+	1335	11392
chrX	102911297	102912297	1000	chrX	102902305	102903145	Gm14854	+	840	8152
chrX	103133448	103134448	1000	chrX	102992954	103124736	Atrx	-	131782	8712
chrX	104521528	104522808	1280	chrX	104539925	104540951	Gm14833	+	1026	17117
chrX	127278779	127279808	1029	chrX	127422205	127422314	AL671906.1	-	109	142397
chrX	147391191	147392191	1000	chrX	147417684	147451865	Gnl3l	-	34181	25493
chrX	160317270	160318401	1131	chrX	160346949	160371598	Ap1s2	+	24649	28548
chrX	163487316	163489093	1777	chrX	163501126	163508312	Gm8817	-	7186	12033
